Size of Data (KB),Server Data Size,Server Data Size (KB),Time to Send,Time to Receive,Processing Time,Topology
3,4670,4.560546875,89,20,109,
3,8544,8.34375,84,30,114,
3,12420,12.12890625,69,42,111,
3,16298,15.91601563,81,26,107,
3,20188,19.71484375,69,24,93,
3,24058,23.49414063,80,37,117,
3,27938,27.28320313,69,22,91,
3,31820,31.07421875,72,23,95,
3,35694,34.85742188,70,38,108,
3,39568,38.640625,69,18,87,
3,43440,42.421875,100,34,134,
3,47328,46.21875,90,20,110,
3,51210,50.00976563,91,55,146,
3,55076,53.78515625,86,27,113,
3,58954,57.57226563,84,31,115,
3,62822,61.34960938,73,19,92,
3,66716,65.15234375,84,52,136,
3,70592,68.9375,93,34,127,
3,74472,72.7265625,110,34,144,
3,78348,76.51171875,115,57,172,
3,82214,80.28710938,86,36,122,
3,86086,84.06835938,68,18,86,
3,89968,87.859375,100,41,141,
3,93842,91.64257813,100,37,137,
3,97722,95.43164063,114,44,158,
3,101600,99.21875,96,34,130,
3,105482,103.0097656,106,42,148,
3,109354,106.7910156,102,34,136,
3,113234,110.5800781,116,48,164,
3,117116,114.3710938,149,51,200,
3,121002,118.1660156,180,66,246,
3,124884,121.9570313,132,44,176,
3,128758,125.7402344,115,45,160,
3,132618,129.5097656,109,40,149,
3,136496,133.296875,112,44,156,
3,140372,137.0820313,113,43,156,
3,144248,140.8671875,106,34,140,BAn20m2 (iteration 1)
3,4678,4.568359375,95,39,134,
3,8544,8.34375,79,27,106,
3,12414,12.12304688,106,37,143,
3,16296,15.9140625,145,56,201,
3,20176,19.703125,91,32,123,
3,24056,23.4921875,80,23,103,
3,27932,27.27734375,83,30,113,
3,31800,31.0546875,91,36,127,
3,35668,34.83203125,85,32,117,
3,39526,38.59960938,97,35,132,
3,43388,42.37109375,96,41,137,
3,47246,46.13867188,92,35,127,
3,51126,49.92773438,74,27,101,
3,55006,53.71679688,85,33,118,
3,58882,57.50195313,69,21,90,
3,62758,61.28710938,72,20,92,
3,66624,65.0625,101,49,150,
3,70512,68.859375,85,33,118,
3,74386,72.64257813,75,40,115,
3,78266,76.43164063,81,34,115,
3,82144,80.21875,77,18,95,
3,86020,84.00390625,83,18,101,
3,89896,87.7890625,95,18,113,
3,93774,91.57617188,88,25,113,
3,97652,95.36328125,84,28,112,
3,101538,99.15820313,97,18,115,
3,105404,102.9335938,99,47,146,
3,109282,106.7207031,81,18,99,
3,113156,110.5039063,83,19,102,
3,117042,114.2988281,113,46,159,
3,120922,118.0878906,130,34,164,
3,124794,121.8691406,90,33,123,
3,128668,125.6523438,85,26,111,
3,132528,129.421875,156,71,227,
3,136400,133.203125,116,29,145,
3,140276,136.9882813,150,34,184,
3,144146,140.7675781,118,37,155,BAn20m2 (iteration 2)
3,4662,4.552734375,68,20,88,
3,8544,8.34375,74,35,109,
3,12420,12.12890625,64,31,95,
3,16296,15.9140625,59,31,90,
3,20178,19.70507813,82,35,117,
3,24056,23.4921875,83,33,116,
3,27928,27.2734375,84,49,133,
3,31814,31.06835938,78,27,105,
3,35688,34.8515625,84,38,122,
3,39558,38.63085938,111,35,146,
3,43430,42.41210938,62,18,80,
3,47300,46.19140625,85,48,133,
3,51176,49.9765625,77,18,95,
3,55048,53.7578125,81,35,116,
3,58918,57.53710938,84,34,118,
3,62796,61.32421875,77,29,106,
3,66684,65.12109375,85,36,121,
3,70560,68.90625,89,14,103,
3,74424,72.6796875,72,18,90,
3,78312,76.4765625,89,33,122,
3,82204,80.27734375,78,21,99,
3,86064,84.046875,86,43,129,
3,89946,87.83789063,92,18,110,
3,93834,91.63476563,72,32,104,
3,97710,95.41992188,100,40,140,
3,101586,99.20507813,123,18,141,
3,105464,102.9921875,95,21,116,
3,109318,106.7558594,74,20,94,
3,113190,110.5371094,147,78,225,
3,117056,114.3125,92,33,125,
3,120936,118.1015625,100,16,116,
3,124808,121.8828125,91,31,122,
3,128694,125.6777344,70,18,88,
3,132576,129.46875,139,58,197,
3,136444,133.2460938,131,81,212,
3,140326,137.0371094,99,47,146,
3,144196,140.8164063,95,33,128,BAn20m2 (iteration 3)
3,4684,4.57421875,61,20,81,
3,8554,8.353515625,64,19,83,
3,12426,12.13476563,71,33,104,
3,16306,15.92382813,56,32,88,
3,20184,19.7109375,70,31,101,
3,24074,23.50976563,60,23,83,
3,27952,27.296875,82,18,100,
3,31822,31.07617188,68,33,101,
3,35706,34.86914063,65,31,96,
3,39588,38.66015625,72,21,93,
3,43474,42.45507813,62,32,94,
3,47358,46.24804688,76,46,122,
3,51254,50.05273438,87,26,113,
3,55138,53.84570313,88,18,106,
3,59022,57.63867188,65,18,83,
3,62916,61.44140625,70,21,91,
3,66798,65.23242188,112,38,150,
3,70672,69.015625,96,19,115,
3,74544,72.796875,81,34,115,
3,78422,76.58398438,71,32,103,
3,82300,80.37109375,70,18,88,
3,86178,84.15820313,92,18,110,
3,90058,87.94726563,68,31,99,
3,93936,91.734375,105,55,160,
3,97806,95.51367188,95,38,133,
3,101690,99.30664063,135,64,199,
3,105574,103.0996094,103,33,136,
3,109456,106.890625,100,39,139,
3,113334,110.6777344,123,70,193,
3,117206,114.4589844,62,17,79,
3,121074,118.2363281,124,65,189,
3,124942,122.0136719,72,18,90,
3,128818,125.7988281,127,43,170,
3,132700,129.5898438,103,34,137,
3,136566,133.3652344,109,45,154,
3,140440,137.1484375,240,179,419,
3,144320,140.9375,112,41,153,BAn20m2 (iteration 4)
3,4664,4.5546875,65,29,94,
3,8540,8.33984375,85,35,120,
3,12426,12.13476563,55,22,77,
3,16298,15.91601563,63,18,81,
3,20162,19.68945313,91,35,126,
3,24034,23.47070313,72,27,99,
3,27920,27.265625,77,28,105,
3,31792,31.046875,87,29,116,
3,35644,34.80859375,90,37,127,
3,39542,38.61523438,219,174,393,
3,43410,42.39257813,83,25,108,
3,47286,46.17773438,97,24,121,
3,51162,49.96289063,54,20,74,
3,55056,53.765625,113,34,147,
3,58924,57.54296875,64,19,83,
3,62798,61.32617188,81,17,98,
3,66676,65.11328125,64,21,85,
3,70544,68.890625,71,20,91,
3,74422,72.67773438,100,33,133,
3,78292,76.45703125,120,45,165,
3,82166,80.24023438,93,33,126,
3,86052,84.03515625,100,36,136,
3,89950,87.84179688,74,30,104,
3,93826,91.62695313,76,24,100,
3,97696,95.40625,85,38,123,
3,101570,99.18945313,83,30,113,
3,105432,102.9609375,82,32,114,
3,109310,106.7480469,74,17,91,
3,113176,110.5234375,96,36,132,
3,117048,114.3046875,75,25,100,
3,120932,118.0976563,115,63,178,
3,124816,121.890625,106,49,155,
3,128698,125.6816406,85,18,103,
3,132576,129.46875,75,23,98,
3,136444,133.2460938,216,160,376,
3,140314,137.0253906,75,18,93,
3,144182,140.8027344,103,51,154,BAn20m2 (iteration 5)
3,4662,4.552734375,62,26,88,
3,8546,8.345703125,55,18,73,
3,12414,12.12304688,69,28,97,
3,16294,15.91210938,67,24,91,
3,20166,19.69335938,67,20,87,
3,24052,23.48828125,54,30,84,
3,27938,27.28320313,54,18,72,
3,31816,31.0703125,56,28,84,
3,35698,34.86132813,66,27,93,
3,39584,38.65625,215,30,245,
3,43438,42.41992188,55,32,87,
3,47316,46.20703125,51,28,79,
3,51174,49.97460938,72,36,108,
3,55054,53.76367188,67,27,94,
3,58924,57.54296875,67,27,94,
3,62802,61.33007813,61,31,92,
3,66672,65.109375,81,28,109,
3,70548,68.89453125,80,29,109,
3,74426,72.68164063,201,23,224,
3,78308,76.47265625,84,17,101,
3,82192,80.265625,65,36,101,
3,86070,84.05273438,109,34,143,
3,89948,87.83984375,60,33,93,
3,93824,91.625,177,26,203,
3,97708,95.41796875,66,26,92,
3,101580,99.19921875,64,21,85,
3,105456,102.984375,85,33,118,
3,109340,106.7773438,82,28,110,
3,113214,110.5605469,175,25,200,
3,117088,114.34375,79,33,112,
3,120976,118.140625,82,31,113,
3,124848,121.921875,121,64,185,
3,128724,125.7070313,104,44,148,
3,132590,129.4824219,243,37,280,
3,136472,133.2734375,103,33,136,
3,140348,137.0585938,76,47,123,
3,144226,140.8457031,72,17,89,
3,148102,144.6308594,91,32,123,
3,151980,148.4179688,185,27,212,
3,155842,152.1894531,84,17,101,
3,159726,155.9824219,81,21,102,
3,163594,159.7597656,105,34,139,
3,167454,163.5292969,99,29,128,
3,171316,167.3007813,241,38,279,
3,175204,171.0976563,140,78,218,
3,179062,174.8652344,92,31,123,
3,182936,178.6484375,87,32,119,
3,186810,182.4316406,88,31,119,
3,190690,186.2207031,724,575,1299,
3,194572,190.0117188,86,33,119,
3,198430,193.7792969,178,124,302,
3,202312,197.5703125,75,21,96,
3,206190,201.3574219,97,33,130,
3,210082,205.1582031,200,31,231,
3,213972,208.9570313,98,33,131,
3,217848,212.7421875,571,510,1081,
3,221722,216.5253906,91,30,121,
3,225596,220.3085938,100,38,138,
3,229462,224.0839844,100,35,135,
3,233342,227.8730469,169,99,268,
3,237214,231.6542969,114,22,136,
3,241088,235.4375,120,18,138,
3,244964,239.2226563,115,34,149,
3,248840,243.0078125,199,24,223,
3,252710,246.7871094,102,34,136,
3,256582,250.5683594,759,696,1455,
3,260468,254.3632813,106,34,140,
3,264338,258.1425781,243,154,397,
3,268218,261.9316406,274,63,337,
3,272090,265.7128906,122,45,167,
3,275962,269.4941406,125,55,180,
3,279826,273.2675781,1222,1150,2372,
3,283712,277.0625,95,35,130,
3,287600,280.859375,203,34,237,
3,291484,284.6523438,118,50,168,
3,295362,288.4394531,432,364,796,
3,299242,292.2285156,109,35,144,
3,303106,296.0019531,524,451,975,
3,306978,299.7832031,117,34,151,
3,310862,303.5761719,116,40,156,
3,314746,307.3691406,1780,1707,3487,
3,318628,311.1601563,138,39,177,
3,322502,314.9433594,119,33,152,
3,326372,318.7226563,212,134,346,
3,330236,322.4960938,100,28,128,BAn20m5 (iteration 1)
3,4672,4.5625,49,18,67,
3,8546,8.345703125,69,27,96,
3,12416,12.125,84,23,107,
3,16310,15.92773438,61,24,85,
3,20190,19.71679688,57,24,81,
3,24082,23.51757813,59,24,83,
3,27954,27.29882813,62,28,90,
3,31840,31.09375,63,27,90,
3,35724,34.88671875,57,33,90,
3,39596,38.66796875,57,30,87,
3,43466,42.44726563,51,29,80,
3,47342,46.23242188,54,25,79,
3,51206,50.00585938,73,36,109,
3,55076,53.78515625,84,25,109,
3,58964,57.58203125,69,22,91,
3,62842,61.36914063,71,24,95,
3,66726,65.16210938,98,33,131,
3,70596,68.94140625,80,34,114,
3,74482,72.73632813,84,50,134,
3,78362,76.52539063,90,39,129,
3,82224,80.296875,100,25,125,
3,86110,84.09179688,68,27,95,
3,89982,87.87304688,69,29,98,
3,93868,91.66796875,531,492,1023,
3,97750,95.45898438,75,31,106,
3,101624,99.2421875,75,29,104,
3,105480,103.0078125,78,26,104,
3,109368,106.8046875,81,34,115,
3,113234,110.5800781,56,17,73,
3,117104,114.359375,57,31,88,
3,120992,118.15625,62,31,93,
3,124876,121.9492188,76,42,118,
3,128758,125.7402344,81,18,99,
3,132638,129.5292969,78,34,112,
3,136508,133.3085938,67,22,89,
3,140382,137.0917969,62,31,93,
3,144258,140.8769531,87,19,106,
3,148136,144.6640625,306,256,562,
3,152014,148.4511719,85,17,102,
3,155896,152.2421875,79,33,112,
3,159772,156.0273438,84,28,112,
3,163632,159.796875,74,27,101,
3,167512,163.5859375,86,34,120,
3,171378,167.3613281,71,19,90,
3,175254,171.1464844,90,18,108,
3,179122,174.9238281,94,36,130,
3,182992,178.703125,69,19,88,
3,186886,182.5058594,69,24,93,
3,190780,186.3085938,84,22,106,
3,194656,190.09375,92,34,126,
3,198528,193.875,1626,1569,3195,
3,202396,197.6523438,82,32,114,
3,206266,201.4316406,85,35,120,
3,210142,205.2167969,64,17,81,
3,214034,209.0175781,84,26,110,
3,217904,212.796875,1992,1937,3929,
3,221796,216.5976563,96,34,130,
3,225684,220.3945313,92,21,113,
3,229556,224.1757813,132,71,203,
3,233432,227.9609375,87,35,122,
3,237306,231.7441406,105,17,122,
3,241186,235.5332031,115,30,145,
3,245072,239.328125,495,439,934,
3,248950,243.1152344,117,39,156,
3,252832,246.90625,103,38,141,
3,256706,250.6894531,105,37,142,
3,260580,254.4726563,1007,951,1958,
3,264460,258.2617188,107,34,141,
3,268340,262.0507813,92,16,108,
3,272230,265.8496094,102,34,136,
3,276118,269.6464844,106,38,144,
3,279992,273.4296875,589,516,1105,
3,283856,277.203125,139,35,174,
3,287716,280.9726563,119,50,169,
3,291582,284.7480469,98,33,131,
3,295468,288.5429688,97,17,114,
3,299354,292.3378906,543,478,1021,
3,303226,296.1191406,113,43,156,
3,307102,299.9042969,143,33,176,
3,310980,303.6914063,150,32,182,
3,314846,307.4667969,101,27,128,
3,318722,311.2519531,142,32,174,
3,322596,315.0351563,2038,1837,3875,
3,326468,318.8164063,107,41,148,
3,330350,322.6074219,116,37,153,BAn20m5 (iteration 2)
3,4676,4.56640625,57,9,66,
3,8556,8.35546875,54,19,73,
3,12424,12.1328125,57,19,76,
3,16284,15.90234375,54,22,76,
3,20164,19.69140625,69,13,82,
3,24038,23.47460938,67,39,106,
3,27912,27.2578125,88,38,126,
3,31778,31.03320313,85,35,120,
3,35650,34.81445313,87,36,123,
3,39502,38.57617188,67,24,91,
3,43376,42.359375,72,30,102,
3,47258,46.15039063,60,24,84,
3,51136,49.9375,67,28,95,
3,55012,53.72265625,78,27,105,
3,58902,57.52148438,68,27,95,
3,62760,61.2890625,67,17,84,
3,66648,65.0859375,67,26,93,
3,70516,68.86328125,66,24,90,
3,74388,72.64453125,80,32,112,
3,78260,76.42578125,85,39,124,
3,82164,80.23828125,59,31,90,
3,86062,84.04492188,84,58,142,
3,89940,87.83203125,93,37,130,
3,93820,91.62109375,107,44,151,
3,97696,95.40625,94,40,134,
3,101560,99.1796875,95,22,117,
3,105438,102.9667969,890,859,1749,
3,109318,106.7558594,61,18,79,
3,113198,110.5449219,63,18,81,
3,117068,114.3242188,88,33,121,
3,120952,118.1171875,66,19,85,
3,124824,121.8984375,66,19,85,
3,128704,125.6875,84,37,121,
3,132576,129.46875,61,25,86,
3,136446,133.2480469,75,31,106,
3,140328,137.0390625,105,34,139,
3,144192,140.8125,88,21,109,
3,148078,144.6074219,617,573,1190,
3,151952,148.390625,80,16,96,
3,155820,152.1679688,101,33,134,
3,159702,155.9589844,70,18,88,
3,163582,159.7480469,109,33,142,
3,167456,163.53125,90,36,126,
3,171334,167.3183594,100,36,136,
3,175210,171.1035156,100,36,136,
3,179094,174.8964844,96,29,125,
3,182964,178.6757813,88,34,122,
3,186840,182.4609375,93,36,129,
3,190730,186.2597656,129,40,169,
3,194602,190.0410156,137,45,182,
3,198474,193.8222656,624,546,1170,
3,202350,197.6074219,100,19,119,
3,206216,201.3828125,509,444,953,
3,210110,205.1855469,114,17,131,
3,213974,208.9589844,112,41,153,
3,217856,212.75,83,28,111,
3,221740,216.5429688,82,32,114,
3,225616,220.328125,105,33,138,
3,229500,224.1210938,123,32,155,
3,233368,227.8984375,133,45,178,
3,237254,231.6933594,1254,1183,2437,
3,241118,235.4667969,697,605,1302,
3,244982,239.2402344,134,41,175,
3,248862,243.0292969,137,39,176,
3,252724,246.8007813,119,33,152,
3,256602,250.5878906,99,33,132,
3,260488,254.3828125,116,48,164,
3,264378,258.1816406,133,64,197,
3,268250,261.9628906,533,472,1005,
3,272140,265.7617188,90,34,124,
3,276018,269.5488281,1392,1325,2717,
3,279894,273.3339844,141,37,178,
3,283774,277.1230469,124,29,153,
3,287632,280.890625,127,52,179,
3,291508,284.6757813,125,47,172,
3,295376,288.453125,158,37,195,
3,299262,292.2480469,243,52,295,
3,303148,296.0429688,122,54,176,
3,307026,299.8300781,150,65,215,
3,310914,303.6269531,723,631,1354,
3,314788,307.4101563,561,472,1033,
3,318664,311.1953125,101,19,120,
3,322548,314.9882813,116,49,165,
3,326438,318.7871094,137,42,179,
3,330316,322.5742188,114,32,146,BAn20m5 (iteration 3)
3,4666,4.556640625,54,9,63,
3,8544,8.34375,76,21,97,
3,12412,12.12109375,54,20,74,
3,16286,15.90429688,63,27,90,
3,20160,19.6875,55,20,75,
3,24046,23.48242188,51,29,80,
3,27916,27.26171875,53,29,82,
3,31782,31.03710938,52,20,72,
3,35648,34.8125,69,25,94,
3,39520,38.59375,69,39,108,
3,43388,42.37109375,69,41,110,
3,47260,46.15234375,51,28,79,
3,51144,49.9453125,61,29,90,
3,55020,53.73046875,53,30,83,
3,58912,57.53125,66,25,91,
3,62794,61.32226563,54,19,73,
3,66660,65.09765625,51,16,67,
3,70532,68.87890625,51,17,68,
3,74394,72.65039063,49,17,66,
3,78268,76.43359375,92,48,140,
3,82152,80.2265625,79,47,126,
3,86042,84.02539063,788,741,1529,
3,89910,87.80273438,70,17,87,
3,93786,91.58789063,59,17,76,
3,97662,95.37304688,62,18,80,
3,101540,99.16015625,58,17,75,
3,105406,102.9355469,65,17,82,
3,109274,106.7128906,68,22,90,
3,113136,110.484375,68,28,96,
3,117014,114.2714844,82,27,109,
3,120904,118.0703125,74,26,100,
3,124770,121.8457031,60,27,87,
3,128636,125.6210938,84,27,111,
3,132510,129.4042969,86,22,108,
3,136386,133.1894531,69,17,86,
3,140274,136.9863281,71,19,90,
3,144154,140.7753906,66,22,88,
3,148026,144.5566406,84,22,106,
3,151904,148.34375,95,18,113,
3,155778,152.1269531,102,34,136,
3,159666,155.9238281,68,17,85,
3,163538,159.7050781,59,16,75,
3,167418,163.4941406,71,25,96,
3,171300,167.2851563,99,16,115,
3,175180,171.0742188,456,404,860,
3,179070,174.8730469,84,21,105,
3,182944,178.65625,86,24,110,
3,186818,182.4394531,84,21,105,
3,190698,186.2285156,109,24,133,
3,194568,190.0078125,108,17,125,
3,198440,193.7890625,116,40,156,
3,202314,197.5722656,104,25,129,
3,206198,201.3652344,113,17,130,
3,210074,205.1503906,98,17,115,
3,213954,208.9394531,1058,1006,2064,
3,217806,212.7011719,756,666,1422,
3,221676,216.4804688,104,35,139,
3,225538,220.2519531,100,42,142,
3,229408,224.03125,166,102,268,
3,233286,227.8183594,116,45,161,
3,237154,231.5957031,115,33,148,
3,241024,235.375,653,599,1252,
3,244908,239.1679688,520,459,979,
3,248768,242.9375,94,32,126,
3,252650,246.7285156,85,23,108,
3,256536,250.5234375,1430,1375,2805,
3,260412,254.3085938,94,36,130,
3,264300,258.1054688,90,33,123,
3,268180,261.8945313,119,54,173,
3,272048,265.671875,119,34,153,
3,275922,269.4550781,729,661,1390,
3,279802,273.2441406,112,39,151,
3,283672,277.0234375,119,32,151,
3,287552,280.8125,119,29,148,
3,291440,284.609375,97,34,131,
3,295326,288.4042969,101,34,135,
3,299208,292.1953125,98,17,115,
3,303078,295.9746094,102,30,132,
3,306932,299.7382813,112,33,145,
3,310802,303.5175781,126,20,146,
3,314674,307.2988281,113,37,150,
3,318540,311.0742188,106,40,146,
3,322408,314.8515625,958,886,1844,
3,326292,318.6445313,108,37,145,
3,330170,322.4316406,122,44,166,BAn20m5 (iteration 4)
3,4680,4.5703125,47,19,66,
3,8558,8.357421875,54,19,73,
3,12442,12.15039063,53,19,72,
3,16318,15.93554688,58,22,80,
3,20204,19.73046875,68,27,95,
3,24076,23.51171875,72,28,100,
3,27952,27.296875,76,30,106,
3,31836,31.08984375,67,28,95,
3,35720,34.8828125,67,30,97,
3,39606,38.67773438,48,28,76,
3,43502,42.48242188,63,26,89,
3,47380,46.26953125,59,32,91,
3,51240,50.0390625,71,17,88,
3,55126,53.83398438,54,29,83,
3,59002,57.61914063,71,33,104,
3,62882,61.40820313,57,21,78,
3,66772,65.20703125,64,23,87,
3,70660,69.00390625,53,17,70,
3,74532,72.78515625,51,16,67,
3,78410,76.57226563,81,17,98,
3,82290,80.36132813,98,48,146,
3,86154,84.13476563,96,45,141,
3,90018,87.90820313,100,41,141,
3,93902,91.70117188,89,37,126,
3,97774,95.48242188,96,26,122,
3,101654,99.27148438,79,28,107,
3,105520,103.046875,464,415,879,
3,109394,106.8300781,72,26,98,
3,113270,110.6152344,77,27,104,
3,117166,114.4199219,81,34,115,
3,121038,118.2011719,601,536,1137,
3,124926,121.9980469,70,16,86,
3,128802,125.7832031,64,17,81,
3,132674,129.5644531,82,18,100,
3,136552,133.3515625,70,17,87,
3,140422,137.1308594,100,36,136,
3,144290,140.9082031,84,27,111,
3,148166,144.6933594,84,22,106,
3,152052,148.4882813,84,20,104,
3,155938,152.2832031,99,32,131,
3,159814,156.0683594,696,661,1357,
3,163700,159.8632813,83,33,116,
3,167572,163.6445313,78,33,111,
3,171448,167.4296875,64,17,81,
3,175328,171.21875,85,34,119,
3,179194,174.9941406,100,37,137,
3,183076,178.7851563,84,17,101,
3,186958,182.5761719,69,20,89,
3,190834,186.3613281,701,654,1355,
3,194726,190.1621094,82,33,115,
3,198616,193.9609375,91,18,109,
3,202500,197.7539063,104,34,138,
3,206382,201.5449219,84,25,109,
3,210274,205.3457031,100,43,143,
3,214150,209.1308594,99,30,129,
3,218032,212.921875,1703,1645,3348,
3,221904,216.703125,84,26,110,
3,225792,220.5,123,45,168,
3,229676,224.2929688,143,54,197,
3,233564,228.0898438,111,46,157,
3,237442,231.8769531,104,30,134,
3,241322,235.6660156,91,33,124,
3,245206,239.4589844,106,47,153,
3,249088,243.25,105,40,145,
3,252958,247.0292969,105,35,140,
3,256848,250.828125,693,622,1315,
3,260720,254.609375,93,17,110,
3,264596,258.3945313,112,36,148,
3,268462,262.1699219,235,168,403,
3,272350,265.9667969,97,38,135,
3,276222,269.7480469,116,41,157,
3,280104,273.5390625,1548,1479,3027,
3,283982,277.3261719,807,750,1557,
3,287860,281.1132813,85,26,111,
3,291740,284.9023438,100,37,137,
3,295616,288.6875,1247,1147,2394,
3,299496,292.4765625,165,53,218,
3,303374,296.2636719,150,18,168,
3,307248,300.046875,138,53,191,
3,311114,303.8222656,125,34,159,
3,314998,307.6152344,632,538,1170,
3,318882,311.4082031,139,33,172,
3,322756,315.1914063,130,40,170,
3,326650,318.9941406,155,58,213,
3,330536,322.7890625,138,48,186,BAn20m5 (iteration 5)
3,4672,4.5625,88,51,139,
3,8560,8.359375,65,23,88,
3,12446,12.15429688,57,26,83,
3,16322,15.93945313,58,26,84,
3,20200,19.7265625,53,19,72,
3,24068,23.50390625,62,26,88,
3,27934,27.27929688,60,29,89,
3,31816,31.0703125,67,31,98,
3,35690,34.85351563,81,52,133,
3,39566,38.63867188,76,28,104,
3,43452,42.43359375,51,30,81,
3,47330,46.22070313,57,19,76,
3,51208,50.0078125,54,31,85,
3,55076,53.78515625,73,23,96,
3,58956,57.57421875,59,22,81,
3,62844,61.37109375,88,41,129,
3,66740,65.17578125,103,18,121,
3,70608,68.953125,62,17,79,
3,74488,72.7421875,61,17,78,
3,78370,76.53320313,87,36,123,
3,82232,80.3046875,81,32,113,
3,86118,84.09960938,81,33,114,
3,89994,87.88476563,101,50,151,
3,93870,91.66992188,93,39,132,
3,97740,95.44921875,104,43,147,
3,101612,99.23046875,1177,1121,2298,
3,105496,103.0234375,132,93,225,
3,109366,106.8027344,55,30,85,
3,113246,110.5917969,64,17,81,
3,117122,114.3769531,65,18,83,
3,120994,118.1582031,88,19,107,
3,124878,121.9511719,68,16,84,
3,128754,125.7363281,71,18,89,
3,132630,129.5214844,72,17,89,
3,136520,133.3203125,85,24,109,
3,140404,137.1132813,92,18,110,
3,144292,140.9101563,103,41,144,
3,148174,144.7011719,85,35,120,
3,152070,148.5058594,82,29,111,
3,155942,152.2871094,73,31,104,
3,159822,156.0761719,76,31,107,
3,163690,159.8535156,81,18,99,
3,167572,163.6445313,99,21,120,
3,171440,167.421875,99,33,132,
3,175316,171.2070313,84,20,104,
3,179192,174.9921875,84,22,106,
3,183072,178.78125,72,23,95,
3,186948,182.5664063,69,22,91,
3,190826,186.3535156,93,33,126,
3,194708,190.1445313,91,29,120,
3,198576,193.921875,101,17,118,
3,202458,197.7128906,516,424,940,
3,206350,201.5136719,1599,1526,3125,
3,210228,205.3007813,105,24,129,
3,214096,209.078125,113,32,145,
3,217974,212.8652344,100,26,126,
3,221850,216.6503906,92,33,125,
3,225720,220.4296875,83,30,113,
3,229598,224.2167969,85,31,116,
3,233478,228.0058594,1305,1253,2558,
3,237364,231.8007813,99,43,142,
3,241240,235.5859375,84,28,112,
3,245128,239.3828125,100,36,136,
3,248996,243.1601563,102,39,141,
3,252856,246.9296875,1254,1201,2455,
3,256734,250.7167969,94,33,127,
3,260606,254.4980469,94,19,113,
3,264492,258.2929688,98,17,115,
3,268366,262.0761719,119,32,151,
3,272248,265.8671875,111,35,146,
3,276130,269.6582031,110,42,152,
3,280006,273.4433594,1438,1364,2802,
3,283884,277.2304688,83,24,107,
3,287766,281.0214844,104,32,136,
3,291636,284.8007813,95,35,130,
3,295524,288.5976563,92,32,124,
3,299408,292.390625,95,33,128,
3,303292,296.1835938,107,32,139,
3,307164,299.9648438,116,36,152,
3,311044,303.7539063,1022,941,1963,
3,314922,307.5410156,126,44,170,
3,318796,311.3242188,148,52,200,
3,322674,315.1113281,151,36,187,
3,326548,318.8945313,100,32,132,
3,330424,322.6796875,109,33,142,
3,334298,326.4628906,115,36,151,
3,338170,330.2441406,137,54,191,
3,342040,334.0234375,2103,2032,4135,
3,345916,337.8085938,113,44,157,
3,349796,341.5976563,112,45,157,
3,353668,345.3789063,105,40,145,
3,357548,349.1679688,110,34,144,
3,361430,352.9589844,1077,1011,2088,
3,365288,356.7265625,1440,1368,2808,
3,369168,360.515625,1371,1270,2641,
3,373052,364.3085938,803,670,1473,
3,376944,368.109375,899,763,1662,
3,380828,371.9023438,616,522,1138,
3,384704,375.6875,644,563,1207,
3,388576,379.46875,541,436,977,
3,392450,383.2519531,631,554,1185,
3,396328,387.0390625,576,486,1062,
3,400212,390.8320313,553,461,1014,
3,404088,394.6171875,640,547,1187,
3,407970,398.4082031,620,525,1145,
3,411850,402.1972656,516,421,937,
3,415720,405.9765625,563,477,1040,
3,419598,409.7636719,715,623,1338,
3,423458,413.5332031,594,495,1089,
3,427338,417.3222656,561,472,1033,
3,431212,421.1054688,650,560,1210,
3,435088,424.890625,607,514,1121,BAn20m7 (iteration 1)
3,4686,4.576171875,46,19,65,
3,8558,8.357421875,89,37,126,
3,12442,12.15039063,53,19,72,
3,16316,15.93359375,53,20,73,
3,20192,19.71875,70,35,105,
3,24074,23.50976563,53,19,72,
3,27942,27.28710938,52,18,70,
3,31818,31.07226563,76,37,113,
3,35698,34.86132813,51,29,80,
3,39572,38.64453125,88,39,127,
3,43436,42.41796875,57,30,87,
3,47332,46.22265625,52,31,83,
3,51208,50.0078125,65,25,90,
3,55088,53.796875,67,26,93,
3,58966,57.58398438,62,24,86,
3,62850,61.37695313,66,23,89,
3,66732,65.16796875,53,30,83,
3,70606,68.95117188,62,20,82,
3,74476,72.73046875,52,30,82,
3,78358,76.52148438,56,29,85,
3,82244,80.31640625,72,33,105,
3,86124,84.10546875,62,18,80,
3,89994,87.88476563,102,47,149,
3,93872,91.671875,55,30,85,
3,97750,95.45898438,74,32,106,
3,101622,99.24023438,1819,1762,3581,
3,105490,103.0175781,227,174,401,
3,109380,106.8164063,79,33,112,
3,113266,110.6113281,103,34,137,
3,117150,114.4042969,98,34,132,
3,121032,118.1953125,115,45,160,
3,124910,121.9824219,75,26,101,
3,128784,125.765625,68,28,96,
3,132648,129.5390625,95,46,141,
3,136520,133.3203125,74,27,101,
3,140412,137.1210938,83,32,115,
3,144292,140.9101563,83,33,116,
3,148168,144.6953125,76,31,107,
3,152044,148.4804688,485,425,910,
3,155926,152.2714844,81,30,111,
3,159816,156.0703125,73,27,100,
3,163698,159.8613281,87,37,124,
3,167586,163.6582031,75,28,103,
3,171452,167.4335938,71,17,88,
3,175324,171.2148438,84,22,106,
3,179198,174.9980469,85,19,104,
3,183084,178.7929688,67,22,89,
3,186964,182.5820313,68,21,89,
3,190840,186.3671875,69,17,86,
3,194724,190.1601563,1671,1611,3282,
3,198598,193.9433594,98,33,131,
3,202462,197.7167969,102,34,136,
3,206342,201.5058594,102,48,150,
3,210220,205.2929688,85,26,111,
3,214094,209.0761719,85,30,115,
3,217964,212.8554688,133,32,165,
3,221854,216.6542969,113,54,167,
3,225726,220.4355469,1958,1898,3856,
3,229606,224.2246094,100,33,133,
3,233488,228.015625,182,124,306,
3,237358,231.7949219,91,33,124,
3,241224,235.5703125,92,34,126,
3,245100,239.3554688,88,31,119,
3,248986,243.1503906,94,31,125,
3,252872,246.9453125,96,38,134,
3,256744,250.7265625,89,31,120,
3,260620,254.5117188,105,37,142,
3,264506,258.3066406,112,34,146,
3,268382,262.0917969,906,840,1746,
3,272240,265.859375,98,41,139,
3,276124,269.6523438,84,17,101,
3,279998,273.4355469,2534,2434,4968,
3,283884,277.2304688,157,48,205,
3,287766,281.0214844,184,62,246,
3,291644,284.8085938,125,34,159,
3,295524,288.5976563,105,39,144,
3,299388,292.3710938,84,23,107,
3,303260,296.1523438,1108,1039,2147,
3,307128,299.9296875,91,33,124,
3,310994,303.7050781,114,33,147,
3,314882,307.5019531,143,35,178,
3,318734,311.2636719,141,33,174,
3,322610,315.0488281,145,34,179,
3,326476,318.8242188,163,34,197,
3,330342,322.5996094,115,27,142,
3,334216,326.3828125,118,33,151,
3,338094,330.1699219,1168,1099,2267,
3,341962,333.9472656,109,35,144,
3,345836,337.7304688,103,36,139,
3,349708,341.5117188,113,43,156,
3,353598,345.3105469,102,35,137,
3,357474,349.0957031,1195,1116,2311,
3,361356,352.8867188,151,71,222,
3,365226,356.6660156,1123,1044,2167,
3,369112,360.4609375,1111,1029,2140,
3,372992,364.25,1093,1012,2105,
3,376880,368.046875,901,828,1729,
3,380758,371.8339844,833,746,1579,
3,384626,375.6113281,534,437,971,
3,388492,379.3867188,657,570,1227,
3,392380,383.1835938,630,532,1162,
3,396270,386.9824219,521,435,956,
3,400154,390.7753906,524,446,970,
3,404050,394.5800781,621,506,1127,
3,407926,398.3652344,554,406,960,
3,411806,402.1542969,561,475,1036,
3,415690,405.9472656,632,492,1124,
3,419574,409.7402344,621,513,1134,
3,423438,413.5136719,628,530,1158,
3,427318,417.3027344,584,489,1073,
3,431194,421.0878906,692,588,1280,
3,435082,424.8847656,536,450,986,BAn20m7 (iteration 2)
3,4686,4.576171875,47,19,66,
3,8558,8.357421875,52,19,71,
3,12442,12.15039063,51,19,70,
3,16322,15.93945313,70,36,106,
3,20212,19.73828125,81,35,116,
3,24082,23.51757813,88,39,127,
3,27952,27.296875,87,39,126,
3,31828,31.08203125,87,38,125,
3,35704,34.8671875,65,26,91,
3,39572,38.64453125,66,35,101,
3,43456,42.4375,51,19,70,
3,47358,46.24804688,52,31,83,
3,51236,50.03515625,66,39,105,
3,55126,53.83398438,52,19,71,
3,58982,57.59960938,49,17,66,
3,62858,61.38476563,51,16,67,
3,66730,65.16601563,58,17,75,
3,70614,68.95898438,75,50,125,
3,74480,72.734375,75,23,98,
3,78358,76.52148438,69,21,90,
3,82242,80.31445313,69,26,95,
3,86130,84.11132813,69,44,113,
3,89996,87.88671875,72,31,103,
3,93874,91.67382813,55,30,85,
3,97752,95.4609375,57,33,90,
3,101626,99.24414063,1775,1746,3521,
3,105504,103.03125,207,161,368,
3,109374,106.8105469,69,31,100,
3,113246,110.5917969,56,17,73,
3,117110,114.3652344,90,37,127,
3,120992,118.15625,91,36,127,
3,124862,121.9355469,86,33,119,
3,128746,125.7285156,84,31,115,
3,132634,129.5253906,84,34,118,
3,136512,133.3125,119,49,168,
3,140384,137.09375,148,81,229,
3,144284,140.9023438,81,17,98,
3,148150,144.6777344,77,17,94,
3,152014,148.4511719,92,27,119,
3,155888,152.234375,96,33,129,
3,159768,156.0234375,98,41,139,
3,163646,159.8105469,104,44,148,
3,167514,163.5878906,106,44,150,
3,171396,167.3789063,88,35,123,
3,175256,171.1484375,72,25,97,
3,179120,174.921875,90,42,132,
3,182990,178.7011719,89,33,122,
3,186864,182.484375,71,17,88,
3,190738,186.2675781,87,33,120,
3,194628,190.0664063,253,196,449,
3,198504,193.8515625,959,903,1862,
3,202374,197.6308594,98,44,142,
3,206252,201.4179688,81,31,112,
3,210130,205.2050781,89,38,127,
3,213998,208.9824219,91,36,127,
3,217870,212.7636719,81,17,98,
3,221748,216.5507813,71,20,91,
3,225626,220.3378906,69,17,86,
3,229508,224.1289063,86,32,118,
3,233384,227.9140625,1188,1136,2324,
3,237264,231.703125,94,32,126,
3,241146,235.4941406,185,127,312,
3,245004,239.2617188,111,46,157,
3,248884,243.0507813,125,59,184,
3,252762,246.8378906,570,463,1033,
3,256640,250.625,149,34,183,
3,260514,254.4082031,153,37,190,
3,264386,258.1894531,678,584,1262,
3,268264,261.9765625,124,33,157,
3,272138,265.7597656,125,32,157,
3,276010,269.5410156,745,670,1415,
3,279874,273.3144531,100,24,124,
3,283750,277.0996094,99,17,116,
3,287634,280.8925781,94,32,126,
3,291500,284.6679688,89,17,106,
3,295372,288.4492188,95,17,112,
3,299252,292.2382813,129,54,183,
3,303140,296.0351563,2633,2561,5194,
3,307014,299.8183594,428,352,780,
3,310884,303.5976563,121,40,161,
3,314768,307.390625,108,32,140,
3,318646,311.1777344,132,32,164,
3,322532,314.9726563,106,35,141,
3,326410,318.7597656,114,46,160,
3,330284,322.5429688,1679,1608,3287,
3,334156,326.3242188,101,33,134,
3,338026,330.1035156,103,34,137,
3,341908,333.8945313,125,45,170,
3,345782,337.6777344,107,35,142,
3,349670,341.4746094,103,39,142,
3,353540,345.2539063,107,34,141,
3,357420,349.0429688,3453,3381,6834,
3,361300,352.8320313,108,34,142,
3,365170,356.6113281,859,789,1648,
3,369038,360.3886719,676,589,1265,
3,372908,364.1679688,817,717,1534,
3,376788,367.9570313,779,704,1483,
3,380678,371.7558594,669,578,1247,
3,384538,375.5253906,785,640,1425,
3,388432,379.328125,516,417,933,
3,392318,383.1230469,587,505,1092,
3,396192,386.90625,570,482,1052,
3,400074,390.6972656,654,584,1238,
3,403946,394.4785156,584,505,1089,
3,407816,398.2578125,512,422,934,
3,411686,402.0371094,544,448,992,
3,415580,405.8398438,724,626,1350,
3,419448,409.6171875,637,548,1185,
3,423332,413.4101563,505,414,919,
3,427216,417.203125,605,532,1137,
3,431086,420.9824219,671,590,1261,
3,434962,424.7675781,568,492,1060,BAn20m7 (iteration 3)
3,4662,4.552734375,47,19,66,
3,8546,8.345703125,42,12,54,
3,12422,12.13085938,48,19,67,
3,16306,15.92382813,50,16,66,
3,20194,19.72070313,68,20,88,
3,24072,23.5078125,48,19,67,
3,27946,27.29101563,48,19,67,
3,31818,31.07226563,60,21,81,
3,35696,34.859375,49,27,76,
3,39558,38.63085938,69,27,96,
3,43428,42.41015625,54,30,84,
3,47314,46.20507813,51,29,80,
3,51186,49.98632813,55,29,84,
3,55060,53.76953125,70,24,94,
3,58940,57.55859375,43,24,67,
3,62826,61.35351563,59,36,95,
3,66698,65.13476563,56,23,79,
3,70568,68.9140625,62,24,86,
3,74456,72.7109375,61,24,85,
3,78322,76.48632813,67,25,92,
3,82208,80.28125,82,29,111,
3,86080,84.0625,56,17,73,
3,89968,87.859375,58,30,88,
3,93842,91.64257813,111,68,179,
3,97714,95.42382813,63,39,102,
3,101586,99.20507813,1469,1428,2897,
3,105460,102.9882813,83,27,110,
3,109340,106.7773438,223,176,399,
3,113230,110.5761719,74,27,101,
3,117106,114.3613281,73,33,106,
3,120992,118.15625,93,37,130,
3,124874,121.9472656,72,21,93,
3,128746,125.7285156,85,32,117,
3,132612,129.5039063,69,20,89,
3,136488,133.2890625,68,22,90,
3,140352,137.0625,73,42,115,
3,144228,140.8476563,69,26,95,
3,148088,144.6171875,79,47,126,
3,151962,148.4003906,84,31,115,
3,155836,152.1835938,100,43,143,
3,159726,155.9824219,84,35,119,
3,163596,159.7617188,79,28,107,
3,167472,163.546875,789,735,1524,
3,171330,167.3144531,84,29,113,
3,175200,171.09375,90,43,133,
3,179074,174.8769531,89,32,121,
3,182960,178.671875,91,40,131,
3,186838,182.4589844,64,17,81,
3,190716,186.2460938,63,18,81,
3,194604,190.0429688,1294,1243,2537,
3,198474,193.8222656,69,17,86,
3,202350,197.6074219,85,20,105,
3,206238,201.4042969,69,21,90,
3,210104,205.1796875,69,17,86,
3,213978,208.9628906,69,16,85,
3,217854,212.7480469,85,32,117,
3,221738,216.5410156,78,19,97,
3,225614,220.3261719,554,502,1056,
3,229480,224.1015625,645,564,1209,
3,233356,227.8867188,83,29,112,
3,237232,231.671875,246,190,436,
3,241112,235.4609375,101,19,120,
3,244990,239.2480469,100,26,126,
3,248876,243.0429688,1470,1389,2859,
3,252740,246.8164063,117,32,149,
3,256634,250.6191406,136,62,198,
3,260518,254.4121094,96,34,130,
3,264404,258.2070313,100,33,133,
3,268264,261.9765625,94,31,125,
3,272154,265.7753906,93,32,125,
3,276020,269.5507813,1147,1066,2213,
3,279900,273.3398438,98,33,131,
3,283778,277.1269531,94,32,126,
3,287660,280.9179688,97,18,115,
3,291528,284.6953125,100,17,117,
3,295410,288.4863281,100,31,131,
3,299298,292.2832031,131,34,165,
3,303184,296.078125,145,54,199,
3,307066,299.8691406,442,367,809,
3,310940,303.6523438,134,54,188,
3,314814,307.4355469,136,50,186,
3,318686,311.2167969,130,42,172,
3,322562,315.0019531,830,726,1556,
3,326434,318.7832031,107,35,142,
3,330308,322.5664063,107,34,141,
3,334180,326.3476563,101,35,136,
3,338058,330.1347656,103,37,140,
3,341934,333.9199219,2391,2322,4713,
3,345826,337.7207031,112,41,153,
3,349714,341.5175781,109,36,145,
3,353590,345.3027344,126,54,180,
3,357472,349.09375,2649,2549,5198,
3,361342,352.8730469,109,32,141,
3,365208,356.6484375,686,616,1302,
3,369080,360.4296875,732,653,1385,
3,372954,364.2128906,666,593,1259,
3,376830,367.9980469,569,498,1067,
3,380716,371.7929688,618,530,1148,
3,384590,375.5761719,646,550,1196,
3,388468,379.3632813,510,426,936,
3,392348,383.1523438,507,415,922,
3,396234,386.9472656,501,412,913,
3,400108,390.7304688,602,512,1114,
3,403998,394.5292969,421,347,768,
3,407890,398.3300781,452,376,828,
3,411776,402.125,740,609,1349,
3,415648,405.90625,750,645,1395,
3,419528,409.6953125,521,445,966,
3,423418,413.4941406,505,428,933,
3,427308,417.2929688,515,425,940,
3,431200,421.09375,668,574,1242,
3,435080,424.8828125,568,478,1046,BAn20m7 (iteration 4)
3,4662,4.552734375,46,19,65,
3,8536,8.3359375,49,19,68,
3,12398,12.10742188,56,22,78,
3,16272,15.890625,54,23,77,
3,20152,19.6796875,51,19,70,
3,24018,23.45507813,67,34,101,
3,27890,27.23632813,52,19,71,
3,31770,31.02539063,62,20,82,
3,35642,34.80664063,65,41,106,
3,39514,38.58789063,54,32,86,
3,43402,42.38476563,55,25,80,
3,47292,46.18359375,56,23,79,
3,51160,49.9609375,55,24,79,
3,55038,53.74804688,57,23,80,
3,58914,57.53320313,53,23,76,
3,62786,61.31445313,68,44,112,
3,66674,65.11132813,50,30,80,
3,70544,68.890625,53,29,82,
3,74422,72.67773438,55,17,72,
3,78292,76.45703125,77,32,109,
3,82176,80.25,83,32,115,
3,86056,84.0390625,84,40,124,
3,89938,87.83007813,84,22,106,
3,93812,91.61328125,70,44,114,
3,97690,95.40039063,78,31,109,
3,101564,99.18359375,70,25,95,
3,105444,102.9726563,72,26,98,
3,109322,106.7597656,1329,1289,2618,
3,113198,110.5449219,58,18,76,
3,117086,114.3417969,53,17,70,
3,120956,118.1210938,63,17,80,
3,124842,121.9160156,76,17,93,
3,128714,125.6972656,60,17,77,
3,132582,129.4746094,83,27,110,
3,136464,133.265625,69,24,93,
3,140352,137.0625,74,13,87,
3,144222,140.8417969,84,38,122,
3,148090,144.6191406,85,34,119,
3,151956,148.3945313,96,33,129,
3,155830,152.1777344,93,38,131,
3,159700,155.9570313,88,34,122,
3,163586,159.7519531,89,33,122,
3,167442,163.5175781,89,41,130,
3,171316,167.3007813,83,37,120,
3,175182,171.0761719,75,28,103,
3,179064,174.8671875,80,32,112,
3,182936,178.6484375,82,32,114,
3,186812,182.4335938,74,17,91,
3,190696,186.2265625,1486,1426,2912,
3,194586,190.0253906,77,17,94,
3,198476,193.8242188,111,39,150,
3,202354,197.6113281,112,46,158,
3,206236,201.4023438,105,39,144,
3,210118,205.1933594,139,70,209,
3,213984,208.96875,129,45,174,
3,217864,212.7578125,134,47,181,
3,221726,216.5292969,1224,1151,2375,
3,225606,220.3183594,68,17,85,
3,229498,224.1191406,85,32,117,
3,233374,227.9042969,68,17,85,
3,237232,231.671875,92,33,125,
3,241112,235.4609375,84,28,112,
3,244978,239.2363281,84,19,103,
3,248866,243.0332031,87,25,112,
3,252738,246.8144531,1791,1738,3529,
3,256626,250.6113281,98,34,132,
3,260502,254.3964844,97,32,129,
3,264374,258.1777344,94,31,125,
3,268256,261.96875,103,35,138,
3,272148,265.7695313,126,49,175,
3,276042,269.5722656,1662,1578,3240,
3,279920,273.359375,79,19,98,
3,283786,277.1347656,123,52,175,
3,287658,280.9160156,107,37,144,
3,291532,284.6992188,132,33,165,
3,295406,288.4824219,164,35,199,
3,299292,292.2773438,111,33,144,
3,303180,296.0742188,437,367,804,
3,307050,299.8535156,116,55,171,
3,310928,303.640625,917,836,1753,
3,314794,307.4160156,102,34,136,
3,318660,311.1914063,100,27,127,
3,322554,314.9941406,100,35,135,
3,326414,318.7636719,103,34,137,
3,330282,322.5410156,1285,1220,2505,
3,334160,326.328125,99,19,118,
3,338030,330.1074219,101,39,140,
3,341904,333.890625,112,32,144,
3,345772,337.6679688,96,35,131,
3,349658,341.4628906,116,51,167,
3,353528,345.2421875,138,50,188,
3,357400,349.0234375,2073,1965,4038,
3,361270,352.8027344,2166,2106,4272,
3,365130,356.5722656,440,375,815,
3,369028,360.3789063,647,582,1229,
3,372904,364.1640625,615,497,1112,
3,376772,367.9414063,808,736,1544,
3,380644,371.7226563,542,465,1007,
3,384530,375.5175781,803,725,1528,
3,388404,379.3007813,793,714,1507,
3,392286,383.0917969,454,375,829,
3,396168,386.8828125,509,434,943,
3,400036,390.6601563,515,437,952,
3,403912,394.4453125,456,349,805,
3,407794,398.2363281,560,451,1011,
3,411668,402.0195313,485,386,871,
3,415534,405.7949219,454,380,834,
3,419406,409.5761719,204,132,336,
3,423270,413.3496094,464,386,850,
3,427146,417.1347656,732,652,1384,
3,431020,420.9179688,691,613,1304,
3,434888,424.6953125,722,635,1357,BAn20m7 (iteration 5)
3,4680,4.5703125,46,19,65,
3,8560,8.359375,57,20,77,
3,12444,12.15234375,67,35,102,
3,16320,15.9375,54,19,73,
3,20198,19.72460938,54,19,73,
3,24064,23.5,51,19,70,
3,27938,27.28320313,49,19,68,
3,31822,31.07617188,51,22,73,
3,35700,34.86328125,49,18,67,
3,39572,38.64453125,51,18,69,
3,43450,42.43164063,58,23,81,
3,47324,46.21484375,45,24,69,
3,51196,49.99609375,67,45,112,
3,55080,53.7890625,70,24,94,
3,58970,57.58789063,68,24,92,
3,62840,61.3671875,85,36,121,
3,66722,65.15820313,88,19,107,
3,70600,68.9453125,66,39,105,
3,74476,72.73046875,53,27,80,
3,78334,76.49804688,68,26,94,
3,82212,80.28515625,68,18,86,
3,86088,84.0703125,55,18,73,
3,89968,87.859375,52,17,69,
3,93844,91.64453125,49,16,65,
3,97710,95.41992188,52,17,69,
3,101586,99.20507813,56,17,73,
3,105452,102.9804688,68,19,87,
3,109324,106.7617188,84,26,110,
3,113194,110.5410156,69,22,91,
3,117072,114.328125,85,52,137,
3,120938,118.1035156,69,38,107,
3,124818,121.8925781,83,27,110,
3,128698,125.6816406,95,42,137,
3,132570,129.4628906,99,41,140,
3,136448,133.25,1624,1572,3196,
3,140330,137.0410156,467,410,877,
3,144234,140.8535156,169,119,288,
3,148092,144.6210938,84,26,110,
3,151976,148.4140625,80,27,107,
3,155842,152.1894531,168,113,281,
3,159722,155.9785156,58,16,74,
3,163590,159.7558594,84,51,135,
3,167476,163.5507813,69,23,92,
3,171350,167.3339844,903,852,1755,
3,175228,171.1210938,72,18,90,
3,179098,174.9003906,98,18,116,
3,182972,178.6835938,94,19,113,
3,186850,182.4707031,84,26,110,
3,190738,186.2675781,89,20,109,
3,194612,190.0507813,559,513,1072,
3,198486,193.8339844,84,27,111,
3,202368,197.625,84,33,117,
3,206240,201.40625,1073,999,2072,
3,210120,205.1953125,130,59,189,
3,214002,208.9863281,833,748,1581,
3,217880,212.7734375,89,33,122,
3,221750,216.5527344,94,37,131,
3,225628,220.3398438,100,32,132,
3,229506,224.1269531,127,50,177,
3,233384,227.9140625,116,39,155,
3,237264,231.703125,101,33,134,
3,241130,235.4785156,96,36,132,
3,244994,239.2519531,103,18,121,
3,248866,243.0332031,104,42,146,
3,252736,246.8125,138,54,192,
3,256634,250.6191406,117,43,160,
3,260502,254.3964844,815,727,1542,
3,264372,258.1757813,119,39,158,
3,268244,261.9570313,107,38,145,
3,272106,265.7285156,90,34,124,
3,275984,269.515625,100,31,131,
3,279874,273.3144531,113,46,159,
3,283750,277.0996094,92,32,124,
3,287632,280.890625,85,22,107,
3,291502,284.6699219,94,37,131,
3,295392,288.46875,325,261,586,
3,299284,292.2695313,181,122,303,
3,303162,296.0566406,374,311,685,
3,307054,299.8574219,111,38,149,
3,310926,303.6386719,246,181,427,
3,314798,307.4199219,105,37,142,
3,318690,311.2207031,100,32,132,
3,322562,315.0019531,102,17,119,
3,326430,318.7792969,102,40,142,
3,330310,322.5683594,100,35,135,
3,334204,326.3710938,2261,2191,4452,
3,338078,330.1542969,214,145,359,
3,341958,333.9433594,125,34,159,
3,345832,337.7265625,135,48,183,
3,349704,341.5078125,155,39,194,
3,353594,345.3066406,123,49,172,
3,357472,349.09375,105,34,139,
3,361346,352.8769531,108,33,141,
3,365228,356.6679688,1745,1677,3422,
3,369108,360.4570313,1771,1705,3476,
3,373006,364.2636719,1087,1000,2087,
3,376884,368.0507813,1265,1175,2440,
3,380766,371.8417969,1203,1111,2314,
3,384636,375.6210938,525,445,970,
3,388512,379.40625,710,628,1338,
3,392380,383.1835938,629,550,1179,
3,396256,386.96875,625,538,1163,
3,400130,390.7519531,555,466,1021,
3,403992,394.5234375,623,541,1164,
3,407860,398.3007813,520,444,964,
3,411732,402.0820313,684,594,1278,
3,415614,405.8730469,681,595,1276,
3,419488,409.65625,803,719,1522,
3,423358,413.4355469,644,566,1210,
3,427238,417.2246094,600,505,1105,
3,431106,421.0019531,577,493,1070,
3,434980,424.7851563,520,441,961,
3,438866,428.5800781,785,704,1489,
3,442744,432.3671875,665,577,1242,
3,446618,436.1503906,656,574,1230,
3,450492,439.9335938,581,465,1046,
3,454370,443.7207031,794,696,1490,
3,458242,447.5019531,728,631,1359,
3,462120,451.2890625,584,493,1077,
3,465996,455.0742188,567,469,1036,
3,469872,458.859375,618,535,1153,
3,473752,462.6484375,800,717,1517,
3,477636,466.4414063,616,519,1135,
3,481522,470.2363281,690,604,1294,
3,485400,474.0234375,932,813,1745,
3,489272,477.8046875,739,530,1269,
3,493148,481.5898438,745,553,1298,
3,497022,485.3730469,605,500,1105,
3,500894,489.1542969,543,440,983,
3,504772,492.9414063,583,469,1052,
3,508630,496.7089844,564,457,1021,
3,512506,500.4941406,631,525,1156,
3,516392,504.2890625,698,554,1252,
3,520264,508.0703125,622,526,1148,
3,524150,511.8652344,676,562,1238,
3,528014,515.6386719,734,566,1300,
3,531874,519.4082031,728,609,1337,
3,535756,523.1992188,699,577,1276,
3,539638,526.9902344,512,381,893,
3,543538,530.7988281,653,546,1199,
3,547424,534.59375,621,514,1135,
3,551308,538.3867188,553,459,1012,
3,555180,542.1679688,589,464,1053,
3,559060,545.9570313,672,564,1236,
3,562934,549.7402344,647,517,1164,BAn20m10 (iteration 1)
3,4668,4.55859375,54,25,79,
3,8538,8.337890625,62,25,87,
3,12416,12.125,47,12,59,
3,16290,15.90820313,49,19,68,
3,20156,19.68359375,50,19,69,
3,24014,23.45117188,64,19,83,
3,27888,27.234375,58,20,78,
3,31764,31.01953125,74,34,108,
3,35632,34.796875,68,18,86,
3,39510,38.58398438,71,19,90,
3,43390,42.37304688,66,26,92,
3,47258,46.15039063,74,52,126,
3,51134,49.93554688,52,31,83,
3,55012,53.72265625,57,31,88,
3,58876,57.49609375,81,37,118,
3,62758,61.28710938,59,29,88,
3,66630,65.06835938,86,39,125,
3,70498,68.84570313,83,38,121,
3,74360,72.6171875,82,37,119,
3,78250,76.41601563,74,28,102,
3,82132,80.20703125,67,27,94,
3,86018,84.00195313,58,25,83,
3,89894,87.78710938,68,29,97,
3,93764,91.56640625,61,24,85,
3,97628,95.33984375,68,29,97,
3,101514,99.13476563,65,26,91,
3,105394,102.9238281,63,25,88,
3,109266,106.7050781,71,27,98,
3,113150,110.4980469,68,31,99,
3,117024,114.28125,65,28,93,
3,120906,118.0722656,74,33,107,
3,124794,121.8691406,65,27,92,
3,128662,125.6464844,92,30,122,
3,132532,129.4257813,74,29,103,
3,136392,133.1953125,2538,2469,5007,
3,140282,136.9941406,164,121,285,
3,144150,140.7714844,264,220,484,
3,148026,144.5566406,99,57,156,
3,151912,148.3515625,86,36,122,
3,155808,152.15625,72,28,100,
3,159678,155.9355469,85,30,115,
3,163560,159.7265625,75,28,103,
3,167444,163.5195313,73,30,103,
3,171302,167.2871094,82,48,130,
3,175160,171.0546875,269,215,484,
3,179040,174.84375,744,681,1425,
3,182914,178.6269531,81,16,97,
3,186798,182.4199219,84,17,101,
3,190688,186.21875,149,84,233,
3,194562,190.0019531,944,894,1838,
3,198446,193.7949219,68,18,86,
3,202326,197.5839844,64,17,81,
3,206190,201.3574219,1089,1042,2131,
3,210066,205.1425781,86,34,120,
3,213950,208.9355469,443,374,817,
3,217828,212.7226563,87,20,107,
3,221716,216.5195313,82,18,100,
3,225586,220.2988281,68,18,86,
3,229460,224.0820313,84,18,102,
3,233358,227.8886719,97,38,135,
3,237234,231.6738281,101,33,134,
3,241112,235.4609375,95,33,128,
3,244992,239.25,128,62,190,
3,248874,243.0410156,120,34,154,
3,252734,246.8105469,101,33,134,
3,256606,250.5917969,129,55,184,
3,260488,254.3828125,822,764,1586,
3,264374,258.1777344,92,32,124,
3,268250,261.9628906,73,18,91,
3,272134,265.7558594,75,19,94,
3,276014,269.5449219,84,20,104,
3,279882,273.3222656,85,27,112,
3,283756,277.1054688,95,33,128,
3,287630,280.8886719,128,49,177,
3,291502,284.6699219,134,50,184,
3,295376,288.453125,962,884,1846,
3,299252,292.2382813,300,205,505,
3,303126,296.0214844,115,35,150,
3,307012,299.8164063,101,17,118,
3,310892,303.6054688,105,32,137,
3,314780,307.4023438,100,27,127,
3,318660,311.1914063,106,33,139,
3,322540,314.9804688,99,33,132,
3,326414,318.7636719,116,21,137,
3,330290,322.5488281,154,35,189,
3,334164,326.3320313,110,40,150,
3,338036,330.1132813,2460,2372,4832,
3,341906,333.8925781,1156,1083,2239,
3,345772,337.6679688,111,41,152,
3,349656,341.4609375,110,37,147,
3,353530,345.2441406,113,36,149,
3,357400,349.0234375,179,51,230,
3,361282,352.8144531,127,36,163,
3,365156,356.5976563,1770,1696,3466,
3,369026,360.3769531,1429,1357,2786,
3,372900,364.1601563,1659,1579,3238,
3,376768,367.9375,366,260,626,
3,380648,371.7265625,1255,1139,2394,
3,384530,375.5175781,804,723,1527,
3,388426,379.3222656,697,618,1315,
3,392304,383.109375,817,740,1557,
3,396182,386.8964844,618,510,1128,
3,400058,390.6816406,656,573,1229,
3,403954,394.4863281,632,548,1180,
3,407828,398.2695313,724,654,1378,
3,411712,402.0625,829,719,1548,
3,415596,405.8554688,778,673,1451,
3,419470,409.6386719,705,619,1324,
3,423348,413.4257813,617,538,1155,
3,427236,417.2226563,750,672,1422,
3,431106,421.0019531,583,501,1084,
3,434976,424.78125,780,692,1472,
3,438846,428.5605469,725,645,1370,
3,442740,432.3632813,599,512,1111,
3,446634,436.1660156,775,674,1449,
3,450520,439.9609375,1089,994,2083,
3,454394,443.7441406,536,419,955,
3,458274,447.5332031,736,639,1375,
3,462164,451.3320313,603,511,1114,
3,466032,455.109375,742,650,1392,
3,469912,458.8984375,577,485,1062,
3,473796,462.6914063,663,580,1243,
3,477674,466.4785156,787,699,1486,
3,481542,470.2558594,936,819,1755,
3,485412,474.0351563,922,833,1755,
3,489294,477.8261719,443,339,782,
3,493170,481.6113281,354,250,604,
3,497046,485.3964844,934,823,1757,
3,500920,489.1796875,950,842,1792,
3,504798,492.9667969,701,566,1267,
3,508684,496.7617188,710,584,1294,
3,512568,500.5546875,569,463,1032,
3,516458,504.3535156,750,600,1350,
3,520330,508.1347656,955,748,1703,
3,524194,511.9082031,723,544,1267,
3,528068,515.6914063,831,691,1522,
3,531946,519.4785156,636,519,1155,
3,535828,523.2695313,739,584,1323,
3,539700,527.0507813,677,563,1240,
3,543574,530.8339844,699,567,1266,
3,547458,534.6269531,671,558,1229,
3,551332,538.4101563,665,554,1219,
3,555220,542.2070313,664,556,1220,
3,559094,545.9902344,694,584,1278,
3,562956,549.7617188,755,632,1387,BAn20m10 (iteration 2)
3,4664,4.5546875,48,19,67,
3,8540,8.33984375,57,19,76,
3,12412,12.12109375,64,19,83,
3,16296,15.9140625,62,34,96,
3,20170,19.69726563,64,34,98,
3,24036,23.47265625,60,19,79,
3,27894,27.24023438,50,18,68,
3,31772,31.02734375,70,34,104,
3,35662,34.82617188,58,19,77,
3,39544,38.6171875,55,18,73,
3,43410,42.39257813,100,76,176,
3,47292,46.18359375,47,29,76,
3,51182,49.98242188,75,32,107,
3,55056,53.765625,66,31,97,
3,58942,57.56054688,51,29,80,
3,62808,61.3359375,67,31,98,
3,66700,65.13671875,59,31,90,
3,70576,68.921875,60,30,90,
3,74434,72.68945313,70,31,101,
3,78302,76.46679688,71,24,95,
3,82176,80.25,76,34,110,
3,86050,84.03320313,61,26,87,
3,89920,87.8125,64,30,94,
3,93804,91.60546875,61,25,86,
3,97668,95.37890625,52,17,69,
3,101548,99.16796875,56,19,75,
3,105414,102.9433594,54,14,68,
3,109280,106.71875,64,29,93,
3,113166,110.5136719,53,30,83,
3,117038,114.2949219,54,31,85,
3,120912,118.078125,81,48,129,
3,124788,121.8632813,89,38,127,
3,128654,125.6386719,84,35,119,
3,132534,129.4277344,87,38,125,
3,136416,133.21875,2412,2364,4776,
3,140296,137.0078125,460,416,876,
3,144172,140.7929688,210,167,377,
3,148052,144.5820313,344,299,643,
3,151924,148.3632813,200,155,355,
3,155804,152.1523438,72,28,100,
3,159684,155.9414063,103,50,153,
3,163568,159.734375,78,29,107,
3,167444,163.5195313,82,31,113,
3,171312,167.296875,91,41,132,
3,175182,171.0761719,1055,1002,2057,
3,179060,174.8632813,117,48,165,
3,182928,178.640625,78,32,110,
3,186802,182.4238281,76,32,108,
3,190666,186.1972656,83,17,100,
3,194542,189.9824219,434,377,811,
3,198432,193.78125,88,31,119,
3,202298,197.5566406,79,32,111,
3,206142,201.3105469,1128,1065,2193,
3,210022,205.0996094,84,31,115,
3,213888,208.875,767,696,1463,
3,217764,212.6601563,76,18,94,
3,221640,216.4453125,560,506,1066,
3,225512,220.2265625,111,33,144,
3,229384,224.0078125,95,31,126,
3,233268,227.8007813,85,30,115,
3,237136,231.578125,86,34,120,
3,241010,235.3613281,92,39,131,
3,244884,239.1445313,110,53,163,
3,248754,242.9238281,99,34,133,
3,252622,246.7011719,93,30,123,
3,256506,250.4941406,398,341,739,
3,260390,254.2871094,128,40,168,
3,264268,258.0742188,128,50,178,
3,268140,261.8554688,82,18,100,
3,272020,265.6445313,110,35,145,
3,275894,269.4277344,93,32,125,
3,279770,273.2128906,100,36,136,
3,283644,276.9960938,116,35,151,
3,287518,280.7792969,115,25,140,
3,291396,284.5664063,126,33,159,
3,295266,288.3457031,1395,1287,2682,
3,299140,292.1289063,141,34,175,
3,303008,295.90625,123,33,156,
3,306878,299.6855469,117,48,165,
3,310744,303.4609375,98,32,130,
3,314622,307.2480469,104,33,137,
3,318496,311.03125,100,19,119,
3,322372,314.8164063,97,33,130,
3,326240,318.59375,105,32,137,
3,330128,322.390625,123,50,173,
3,333986,326.1582031,1672,1591,3263,
3,337858,329.9394531,145,49,194,
3,341742,333.7324219,110,36,146,
3,345604,337.5039063,866,795,1661,
3,349482,341.2910156,146,56,202,
3,353356,345.0742188,133,38,171,
3,357232,348.859375,115,33,148,
3,361118,352.6542969,108,32,140,
3,364986,356.4316406,2801,2725,5526,
3,368870,360.2246094,1063,990,2053,
3,372746,364.0097656,1477,1384,2861,
3,376636,367.8085938,1236,1158,2394,
3,380516,371.5976563,835,731,1566,
3,384392,375.3828125,645,553,1198,
3,388280,379.1796875,885,792,1677,
3,392178,382.9863281,601,512,1113,
3,396056,386.7734375,714,619,1333,
3,399952,390.578125,662,575,1237,
3,403830,394.3652344,503,431,934,
3,407712,398.15625,654,553,1207,
3,411590,401.9433594,644,553,1197,
3,415442,405.7050781,879,766,1645,
3,419318,409.4902344,683,601,1284,
3,423174,413.2558594,677,601,1278,
3,427038,417.0292969,863,777,1640,
3,430930,420.8300781,608,529,1137,
3,434806,424.6152344,622,528,1150,
3,438688,428.40625,566,486,1052,
3,442566,432.1933594,657,575,1232,
3,446436,435.9726563,728,648,1376,
3,450310,439.7558594,713,570,1283,
3,454192,443.546875,385,288,673,
3,458060,447.3242188,763,669,1432,
3,461942,451.1152344,834,747,1581,
3,465814,454.8964844,688,598,1286,
3,469704,458.6953125,754,667,1421,
3,473564,462.4648438,565,475,1040,
3,477454,466.2636719,978,894,1872,
3,481328,470.046875,652,565,1217,
3,485204,473.8320313,701,603,1304,
3,489086,477.6230469,545,443,988,
3,492956,481.4023438,720,615,1335,
3,496838,485.1933594,853,751,1604,
3,500712,488.9765625,654,533,1187,
3,504582,492.7558594,854,751,1605,
3,508450,496.5332031,637,513,1150,
3,512338,500.3300781,825,733,1558,
3,516206,504.1074219,970,849,1819,
3,520084,507.8945313,754,634,1388,
3,523966,511.6855469,592,480,1072,
3,527852,515.4804688,798,673,1471,
3,531726,519.2636719,668,556,1224,
3,535590,523.0371094,678,548,1226,
3,539462,526.8183594,632,517,1149,
3,543332,530.5976563,610,492,1102,
3,547192,534.3671875,755,633,1388,
3,551062,538.1464844,609,512,1121,
3,554944,541.9375,701,593,1294,
3,558828,545.7304688,675,542,1217,
3,562710,549.5214844,753,638,1391,BAn20m10 (iteration 3)
3,4658,4.548828125,39,11,50,
3,8536,8.3359375,48,12,60,
3,12426,12.13476563,51,18,69,
3,16306,15.92382813,51,19,70,
3,20174,19.70117188,64,48,112,
3,24042,23.47851563,49,19,68,
3,27914,27.25976563,57,25,82,
3,31778,31.03320313,52,19,71,
3,35638,34.80273438,90,32,122,
3,39518,38.59179688,64,31,95,
3,43404,42.38671875,84,25,109,
3,47284,46.17578125,85,55,140,
3,51152,49.953125,53,34,87,
3,55018,53.72851563,62,24,86,
3,58898,57.51757813,56,30,86,
3,62782,61.31054688,52,30,82,
3,66666,65.10351563,52,29,81,
3,70544,68.890625,54,30,84,
3,74420,72.67578125,54,21,75,
3,78316,76.48046875,57,23,80,
3,82194,80.26757813,51,16,67,
3,86064,84.046875,53,16,69,
3,89938,87.83007813,66,32,98,
3,93792,91.59375,90,32,122,
3,97658,95.36914063,77,17,94,
3,101542,99.16210938,66,19,85,
3,105422,102.9511719,85,35,120,
3,109290,106.7285156,66,31,97,
3,113162,110.5097656,113,62,175,
3,117038,114.2949219,73,26,99,
3,120918,118.0839844,66,27,93,
3,124794,121.8691406,84,33,117,
3,128672,125.65625,96,44,140,
3,132552,129.4453125,87,35,122,
3,136436,133.2382813,2206,2159,4365,
3,140320,137.03125,201,149,350,
3,144198,140.8183594,197,154,351,
3,148070,144.5996094,70,28,98,
3,151954,148.3925781,83,27,110,
3,155834,152.1816406,74,30,104,
3,159722,155.9785156,67,19,86,
3,163596,159.7617188,67,19,86,
3,167470,163.5449219,62,18,80,
3,171350,167.3339844,60,32,92,
3,175222,171.1152344,73,32,105,
3,179104,174.90625,549,486,1035,
3,182980,178.6914063,85,32,117,
3,186854,182.4746094,136,87,223,
3,190730,186.2597656,77,20,97,
3,194598,190.0371094,84,26,110,
3,198486,193.8339844,83,16,99,
3,202368,197.625,942,887,1829,
3,206248,201.4140625,94,29,123,
3,210132,205.2070313,145,43,188,
3,214020,209.0039063,633,568,1201,
3,217904,212.796875,76,17,93,
3,221770,216.5722656,70,18,88,
3,225652,220.3632813,86,17,103,
3,229530,224.1503906,73,17,90,
3,233406,227.9355469,90,32,122,
3,237290,231.7285156,90,33,123,
3,241162,235.5097656,84,32,116,
3,245042,239.2988281,85,34,119,
3,248898,243.0644531,100,38,138,
3,252756,246.8320313,109,32,141,
3,256624,250.609375,213,155,368,
3,260496,254.390625,588,527,1115,
3,264382,258.1855469,99,38,137,
3,268260,261.9726563,95,32,127,
3,272126,265.7480469,97,33,130,
3,275998,269.5292969,96,18,114,
3,279886,273.3261719,84,26,110,
3,283776,277.125,100,36,136,
3,287650,280.9082031,90,32,122,
3,291520,284.6875,91,40,131,
3,295388,288.4648438,1344,1264,2608,
3,299250,292.2363281,109,33,142,
3,303128,296.0234375,138,53,191,
3,307004,299.8085938,169,54,223,
3,310874,303.5878906,144,53,197,
3,314742,307.3652344,113,39,152,
3,318620,311.1523438,104,33,137,
3,322496,314.9375,121,41,162,
3,326382,318.7324219,111,33,144,
3,330256,322.515625,101,32,133,
3,334130,326.2988281,1686,1618,3304,
3,338018,330.0957031,104,39,143,
3,341902,333.8886719,103,39,142,
3,345774,337.6699219,998,931,1929,
3,349638,341.4433594,115,43,158,
3,353510,345.2246094,132,43,175,
3,357384,349.0078125,134,37,171,
3,361262,352.7949219,111,34,145,
3,365138,356.5800781,2051,1977,4028,
3,369024,360.375,1623,1550,3173,
3,372906,364.1660156,1012,913,1925,
3,376774,367.9433594,200,122,322,
3,380648,371.7265625,431,340,771,
3,384510,375.4980469,1216,1146,2362,
3,388400,379.296875,1019,945,1964,
3,392286,383.0917969,883,794,1677,
3,396180,386.8945313,665,592,1257,
3,400064,390.6875,551,477,1028,
3,403934,394.4667969,669,593,1262,
3,407818,398.2597656,589,514,1103,
3,411698,402.0488281,691,608,1299,
3,415574,405.8339844,688,606,1294,
3,419446,409.6152344,596,511,1107,
3,423326,413.4042969,464,387,851,
3,427200,417.1875,835,760,1595,
3,431066,420.9628906,611,526,1137,
3,434948,424.7539063,935,851,1786,
3,438804,428.5195313,479,398,877,
3,442678,432.3027344,737,634,1371,
3,446546,436.0800781,628,541,1169,
3,450414,439.8574219,973,848,1821,
3,454292,443.6445313,729,617,1346,
3,458166,447.4277344,685,599,1284,
3,462034,451.2050781,533,444,977,
3,465910,454.9902344,696,611,1307,
3,469784,458.7734375,625,530,1155,
3,473668,462.5664063,764,679,1443,
3,477554,466.3613281,721,619,1340,
3,481438,470.1542969,626,538,1164,
3,485302,473.9277344,804,711,1515,
3,489170,477.7050781,671,547,1218,
3,493038,481.4824219,431,310,741,
3,496916,485.2695313,900,789,1689,
3,500796,489.0585938,1165,1017,2182,
3,504680,492.8515625,785,672,1457,
3,508558,496.6386719,810,684,1494,
3,512422,500.4121094,684,571,1255,
3,516298,504.1972656,965,848,1813,
3,520170,507.9785156,644,535,1179,
3,524046,511.7636719,802,704,1506,
3,527924,515.5507813,612,490,1102,
3,531806,519.3417969,652,511,1163,
3,535690,523.1347656,530,425,955,
3,539572,526.9257813,585,466,1051,
3,543456,530.71875,665,547,1212,
3,547348,534.5195313,695,597,1292,
3,551226,538.3066406,773,661,1434,
3,555116,542.1054688,741,617,1358,
3,558992,545.890625,652,530,1182,
3,562854,549.6621094,678,568,1246,BAn20m10 (iteration 4)
3,4678,4.568359375,46,18,64,
3,8542,8.341796875,51,19,70,
3,12424,12.1328125,52,23,75,
3,16302,15.91992188,73,38,111,
3,20178,19.70507813,62,25,87,
3,24058,23.49414063,53,23,76,
3,27938,27.28320313,85,29,114,
3,31820,31.07421875,55,19,74,
3,35688,34.8515625,55,19,74,
3,39558,38.63085938,131,85,216,
3,43438,42.41992188,49,18,67,
3,47312,46.203125,49,18,67,
3,51170,49.97070313,69,29,98,
3,55040,53.75,50,18,68,
3,58912,57.53125,50,19,69,
3,62790,61.31835938,68,33,101,
3,66658,65.09570313,71,34,105,
3,70544,68.890625,61,28,89,
3,74416,72.671875,66,32,98,
3,78300,76.46484375,62,25,87,
3,82178,80.25195313,59,27,86,
3,86054,84.03710938,61,27,88,
3,89950,87.84179688,61,26,87,
3,93822,91.62304688,53,19,72,
3,97704,95.4140625,69,34,103,
3,101576,99.1953125,63,25,88,
3,105458,102.9863281,70,26,96,
3,109336,106.7734375,73,32,105,
3,113232,110.578125,73,34,107,
3,117092,114.3476563,56,17,73,
3,120978,118.1425781,77,33,110,
3,124850,121.9238281,77,33,110,
3,128726,125.7089844,64,17,81,
3,132598,129.4902344,63,16,79,
3,136482,133.2832031,61,17,78,
3,140364,137.0742188,77,17,94,
3,144240,140.859375,57,17,74,
3,148120,144.6484375,72,17,89,
3,151992,148.4296875,68,18,86,
3,155860,152.2070313,85,41,126,
3,159722,155.9785156,67,26,93,
3,163596,159.7617188,253,212,465,
3,167478,163.5527344,227,165,392,
3,171350,167.3339844,2314,2217,4531,
3,175218,171.1113281,357,309,666,
3,179100,174.9023438,66,16,82,
3,182968,178.6796875,75,30,105,
3,186842,182.4628906,86,41,127,
3,190716,186.2460938,76,29,105,
3,194600,190.0390625,74,28,102,
3,198482,193.8300781,83,34,117,
3,202352,197.609375,104,55,159,
3,206234,201.4003906,83,30,113,
3,210108,205.1835938,86,29,115,
3,213962,208.9472656,110,35,145,
3,217856,212.75,93,40,133,
3,221722,216.5253906,137,73,210,
3,225606,220.3183594,81,31,112,
3,229486,224.1074219,83,31,114,
3,233368,227.8984375,849,798,1647,
3,237246,231.6855469,69,17,86,
3,241126,235.4746094,83,32,115,
3,245008,239.265625,84,32,116,
3,248886,243.0527344,85,26,111,
3,252768,246.84375,69,16,85,
3,256634,250.6191406,536,476,1012,
3,260516,254.4101563,720,657,1377,
3,264400,258.203125,102,32,134,
3,268282,261.9941406,88,16,104,
3,272170,265.7910156,490,434,924,
3,276052,269.5820313,100,22,122,
3,279924,273.3632813,271,208,479,
3,283804,277.1523438,147,74,221,
3,287684,280.9414063,87,33,120,
3,291562,284.7285156,84,25,109,
3,295430,288.5058594,1947,1874,3821,
3,299310,292.2949219,170,81,251,
3,303190,296.0839844,202,118,320,
3,307080,299.8828125,255,186,441,
3,310954,303.6660156,377,299,676,
3,314814,307.4355469,293,234,527,
3,318694,311.2246094,216,153,369,
3,322590,315.0292969,98,32,130,
3,326466,318.8144531,124,57,181,
3,330336,322.59375,1883,1809,3692,
3,334216,326.3828125,179,74,253,
3,338106,330.1816406,280,158,438,
3,341974,333.9589844,307,168,475,
3,345864,337.7578125,332,189,521,
3,349748,341.5507813,346,224,570,
3,353624,345.3359375,2968,2809,5777,
3,357514,349.1347656,1185,1100,2285,
3,361396,352.9257813,1010,866,1876,
3,365274,356.7128906,1014,844,1858,
3,369162,360.5097656,587,418,1005,
3,373040,364.296875,925,768,1693,
3,376900,368.0664063,786,490,1276,
3,380770,371.8457031,722,563,1285,
3,384650,375.6347656,627,444,1071,
3,388512,379.40625,840,378,1218,
3,392406,383.2089844,1351,374,1725,
3,396286,386.9980469,704,67,771,
3,400160,390.78125,367,270,637,
3,404026,394.5566406,622,440,1062,
3,407912,398.3515625,512,409,921,
3,411796,402.1445313,1242,465,1707,
3,415680,405.9375,1206,547,1753,
3,419540,409.7070313,628,395,1023,
3,423404,413.4804688,458,320,778,
3,427288,417.2734375,562,427,989,
3,431186,421.0800781,705,610,1315,
3,435060,424.8632813,831,741,1572,
3,438946,428.6582031,700,598,1298,
3,442838,432.4589844,651,546,1197,
3,447408,436.921875,805,687,1492,
3,451988,441.3945313,877,769,1646,
3,456556,445.8554688,1202,1099,2301,
3,461130,450.3222656,359,254,613,
3,465714,454.7988281,893,791,1684,
3,470292,459.2695313,1504,1386,2890,
3,474174,463.0605469,496,363,859,
3,478050,466.8457031,719,624,1343,
3,481926,470.6308594,503,370,873,
3,485794,474.4082031,938,730,1668,
3,489678,478.2011719,651,558,1209,
3,493556,481.9882813,857,742,1599,
3,497446,485.7871094,905,814,1719,
3,501338,489.5878906,606,507,1113,
3,505222,493.3808594,574,479,1053,
3,509106,497.1738281,807,711,1518,
3,512994,500.9707031,644,542,1186,
3,516876,504.7617188,720,626,1346,
3,520746,508.5410156,569,455,1024,
3,524626,512.3300781,786,675,1461,
3,528510,516.1230469,599,502,1101,
3,532376,519.8984375,852,710,1562,
3,536254,523.6855469,901,784,1685,
3,540144,527.484375,814,699,1513,
3,544026,531.2753906,633,517,1150,
3,547908,535.0664063,855,755,1610,
3,551792,538.859375,666,566,1232,
3,555662,542.6386719,888,786,1674,
3,559520,546.40625,836,722,1558,
3,563390,550.1855469,876,762,1638,
3,567264,553.96875,755,648,1403,
3,571146,557.7597656,830,701,1531,
3,575024,561.546875,750,626,1376,
3,578900,565.3320313,937,829,1766,
3,582786,569.1269531,728,607,1335,
3,586676,572.9257813,900,785,1685,
3,590554,576.7128906,889,733,1622,
3,594436,580.5039063,1007,874,1881,
3,598306,584.2832031,931,791,1722,
3,602172,588.0585938,771,611,1382,
3,606054,591.8496094,748,605,1353,
3,609932,595.6367188,908,774,1682,
3,613802,599.4160156,829,708,1537,
3,617686,603.2089844,909,793,1702,
3,621558,606.9902344,850,732,1582,
3,625438,610.7792969,685,567,1252,
3,629306,614.5566406,1036,840,1876,
3,633202,618.3613281,726,611,1337,
3,637068,622.1367188,1005,876,1881,
3,640942,625.9199219,826,697,1523,
3,644820,629.7070313,901,781,1682,
3,648690,633.4863281,1077,924,2001,
3,652568,637.2734375,839,673,1512,
3,656452,641.0664063,844,682,1526,
3,660334,644.8574219,749,610,1359,
3,664230,648.6621094,780,640,1420,
3,668102,652.4433594,895,734,1629,
3,671970,656.2207031,805,654,1459,
3,675852,660.0117188,880,718,1598,
3,679738,663.8066406,804,656,1460,
3,683622,667.5996094,805,666,1471,
3,687496,671.3828125,764,636,1400,
3,691374,675.1699219,747,609,1356,
3,695280,678.984375,876,726,1602,
3,699146,682.7597656,879,709,1588,
3,703024,686.546875,917,734,1651,BAn20m15 (iteration 1)
3,4680,4.5703125,78,29,107,
3,8556,8.35546875,69,19,88,
3,12438,12.14648438,68,25,93,
3,16326,15.94335938,69,20,89,
3,20198,19.72460938,54,14,68,
3,24082,23.51757813,68,21,89,
3,27958,27.30273438,69,24,93,
3,31834,31.08789063,69,24,93,
3,35710,34.87304688,73,27,100,
3,39570,38.64257813,75,28,103,
3,43442,42.42382813,79,29,108,
3,47306,46.19726563,96,36,132,
3,51190,49.99023438,84,29,113,
3,55062,53.77148438,86,32,118,
3,58930,57.54882813,95,34,129,
3,62804,61.33203125,98,33,131,
3,66680,65.1171875,89,29,118,
3,70556,68.90234375,78,26,104,
3,74416,72.671875,89,28,117,
3,78298,76.46289063,87,28,115,
3,82166,80.24023438,114,31,145,
3,86054,84.03710938,94,29,123,
3,89948,87.83984375,115,38,153,
3,93828,91.62890625,106,36,142,
3,97704,95.4140625,114,35,149,
3,101584,99.203125,122,27,149,
3,105480,103.0078125,119,35,154,
3,109364,106.8007813,107,27,134,
3,113234,110.5800781,122,31,153,
3,117110,114.3652344,98,39,137,
3,120986,118.1503906,92,39,131,
3,124860,121.9335938,97,44,141,
3,128746,125.7285156,90,37,127,
3,132622,129.5136719,110,49,159,
3,136520,133.3203125,174,110,284,
3,140396,137.1054688,116,54,170,
3,144274,140.8925781,96,34,130,
3,148158,144.6855469,99,25,124,
3,152044,148.4804688,84,21,105,
3,155928,152.2734375,84,28,112,
3,159786,156.0410156,79,36,115,
3,163658,159.8222656,91,33,124,
3,167544,163.6171875,1152,1060,2212,
3,171406,167.3886719,3489,3372,6861,
3,175292,171.1835938,155,37,192,
3,179182,174.9824219,193,50,243,
3,183052,178.7617188,198,50,248,
3,186920,182.5390625,123,34,157,
3,190790,186.3183594,1031,953,1984,
3,194664,190.1015625,276,207,483,
3,198538,193.8847656,469,393,862,
3,202408,197.6640625,185,79,264,
3,206298,201.4628906,449,354,803,
3,210178,205.2519531,109,34,143,
3,214056,209.0390625,206,35,241,
3,217928,212.8203125,150,49,199,
3,221820,216.6210938,143,49,192,
3,225682,220.3925781,172,58,230,
3,229550,224.1699219,137,38,175,
3,233420,227.9492188,125,33,158,
3,237284,231.7226563,112,29,141,
3,241168,235.515625,125,33,158,
3,245044,239.3007813,135,33,168,
3,248928,243.09375,129,34,163,
3,252808,246.8828125,1972,1836,3808,
3,256694,250.6777344,123,38,161,
3,260582,254.4746094,100,36,136,
3,264448,258.25,134,48,182,
3,268306,262.0175781,151,33,184,
3,272184,265.8046875,198,67,265,
3,276058,269.5878906,167,32,199,
3,279932,273.3710938,112,36,148,
3,283808,277.15625,131,49,180,
3,287688,280.9453125,111,42,153,
3,291564,284.7304688,2383,2315,4698,
3,295436,288.5117188,196,61,257,
3,299300,292.2851563,257,94,351,
3,303178,296.0722656,214,56,270,
3,307054,299.8574219,187,41,228,
3,310934,303.6464844,170,43,213,
3,314808,307.4296875,203,41,244,
3,318692,311.2226563,209,70,279,
3,322574,315.0136719,136,40,176,
3,326456,318.8046875,2626,2546,5172,
3,330330,322.5878906,1906,1818,3724,
3,334206,326.3730469,879,783,1662,
3,338070,330.1464844,632,533,1165,
3,341956,333.9414063,537,426,963,
3,345830,337.7246094,570,491,1061,
3,349712,341.515625,686,589,1275,
3,353570,345.2832031,721,633,1354,
3,357454,349.0761719,762,685,1447,
3,361328,352.859375,852,509,1361,
3,365204,356.6445313,746,389,1135,
3,369074,360.4238281,820,478,1298,
3,372952,364.2109375,632,396,1028,
3,376838,368.0058594,636,537,1173,
3,380718,371.7949219,427,321,748,
3,384602,375.5878906,667,578,1245,
3,388470,379.3652344,796,693,1489,
3,392354,383.1582031,723,627,1350,
3,396244,386.9570313,664,571,1235,
3,400142,390.7636719,700,596,1296,
3,404030,394.5605469,705,587,1292,
3,407906,398.3457031,617,443,1060,
3,411786,402.1347656,742,639,1381,
3,415660,405.9179688,690,583,1273,
3,419530,409.6972656,705,594,1299,
3,423396,413.4726563,775,681,1456,
3,427278,417.2636719,594,518,1112,
3,431162,421.0566406,747,654,1401,
3,435056,424.859375,735,639,1374,
3,438942,428.6542969,700,609,1309,
3,442816,432.4375,714,632,1346,
3,447396,436.9101563,814,704,1518,
3,451970,441.3769531,807,693,1500,
3,456540,445.8398438,950,846,1796,
3,461116,450.3085938,1487,972,2459,
3,465692,454.7773438,894,416,1310,
3,470266,459.2441406,1000,451,1451,
3,474148,463.0351563,369,263,632,
3,478024,466.8203125,485,397,882,
3,481908,470.6132813,565,476,1041,
3,485784,474.3984375,823,733,1556,
3,489664,478.1875,598,506,1104,
3,493548,481.9804688,847,745,1592,
3,497416,485.7578125,811,702,1513,
3,501276,489.5273438,571,464,1035,
3,505154,493.3144531,685,600,1285,
3,509040,497.109375,603,511,1114,
3,512904,500.8828125,702,607,1309,
3,516776,504.6640625,616,526,1142,
3,520658,508.4550781,653,563,1216,
3,524522,512.2285156,622,529,1151,
3,528390,516.0058594,770,672,1442,
3,532274,519.7988281,209,67,276,
3,536146,523.5800781,1008,882,1890,
3,540026,527.3691406,1020,902,1922,
3,543908,531.1601563,953,820,1773,
3,547794,534.9550781,623,518,1141,
3,551668,538.7382813,772,660,1432,
3,555532,542.5117188,724,595,1319,
3,559406,546.2949219,883,760,1643,
3,563298,550.0957031,976,855,1831,
3,567178,553.8847656,813,675,1488,
3,571066,557.6816406,1097,972,2069,
3,574942,561.4667969,745,622,1367,
3,578828,565.2617188,1014,870,1884,
3,582706,569.0488281,762,635,1397,
3,586586,572.8378906,753,634,1387,
3,590454,576.6152344,1274,1128,2402,
3,594332,580.4023438,551,408,959,
3,598212,584.1914063,724,604,1328,
3,602092,587.9804688,918,783,1701,
3,605968,591.765625,955,805,1760,
3,609856,595.5625,773,626,1399,
3,613730,599.3457031,940,806,1746,
3,617596,603.1210938,649,526,1175,
3,621470,606.9042969,846,716,1562,
3,625340,610.6835938,896,772,1668,
3,629222,614.4746094,694,548,1242,
3,633086,618.2480469,878,753,1631,
3,636970,622.0410156,873,753,1626,
3,640844,625.8242188,681,565,1246,
3,644734,629.6230469,1066,931,1997,
3,648614,633.4121094,941,774,1715,
3,652484,637.1914063,669,507,1176,
3,656358,640.9746094,625,477,1102,
3,660224,644.75,668,493,1161,
3,664088,648.5234375,668,513,1181,
3,667968,652.3125,692,564,1256,
3,671842,656.0957031,648,510,1158,
3,675722,659.8847656,685,559,1244,
3,679598,663.6699219,809,668,1477,
3,683460,667.4414063,786,625,1411,
3,687340,671.2304688,747,627,1374,
3,691224,675.0234375,680,544,1224,
3,695102,678.8105469,716,582,1298,
3,698980,682.5976563,623,492,1115,
3,702860,686.3867188,691,565,1256,BAn20m15 (iteration 2)
3,4668,4.55859375,59,18,77,
3,8546,8.345703125,63,18,81,
3,12436,12.14453125,79,18,97,
3,16306,15.92382813,94,35,129,
3,20184,19.7109375,84,32,116,
3,24054,23.49023438,69,21,90,
3,27928,27.2734375,73,25,98,
3,31806,31.06054688,114,34,148,
3,35688,34.8515625,82,35,117,
3,39558,38.63085938,68,19,87,
3,43414,42.39648438,68,18,86,
3,47294,46.18554688,63,18,81,
3,51170,49.97070313,90,42,132,
3,55056,53.765625,85,20,105,
3,58928,57.546875,85,22,107,
3,62808,61.3359375,97,27,124,
3,66702,65.13867188,82,18,100,
3,70576,68.921875,77,17,94,
3,74446,72.70117188,78,20,98,
3,78318,76.48242188,82,18,100,
3,82192,80.265625,96,31,127,
3,86066,84.04882813,99,27,126,
3,89946,87.83789063,97,24,121,
3,93834,91.63476563,91,18,109,
3,97702,95.41210938,162,34,196,
3,101582,99.20117188,133,39,172,
3,105448,102.9765625,116,34,150,
3,109336,106.7734375,96,18,114,
3,113208,110.5546875,83,34,117,
3,117098,114.3535156,55,18,73,
3,120964,118.1289063,59,17,76,
3,124826,121.9003906,69,17,86,
3,128708,125.6914063,73,35,108,
3,132586,129.4785156,57,16,73,
3,136454,133.2558594,80,33,113,
3,140314,137.0253906,99,39,138,
3,144196,140.8164063,84,33,117,
3,148064,144.59375,63,17,80,
3,151936,148.375,84,35,119,
3,155812,152.1601563,83,38,121,
3,159694,155.9511719,66,17,83,
3,163562,159.7285156,85,35,120,
3,167438,163.5136719,1080,1010,2090,
3,171308,167.2929688,2222,2135,4357,
3,175198,171.0917969,927,826,1753,
3,179078,174.8808594,421,330,751,
3,182942,178.6542969,914,829,1743,
3,186816,182.4375,105,34,139,
3,190686,186.2167969,256,184,440,
3,194564,190.0039063,257,187,444,
3,198450,193.7988281,558,470,1028,
3,202328,197.5859375,163,83,246,
3,206206,201.3730469,265,132,397,
3,210082,205.1582031,280,89,369,
3,213968,208.953125,377,33,410,
3,217840,212.734375,246,48,294,
3,221718,216.5214844,219,46,265,
3,225594,220.3066406,270,28,298,
3,229472,224.09375,166,23,189,
3,233348,227.8789063,79,17,96,
3,237224,231.6640625,93,33,126,
3,241104,235.453125,93,34,127,
3,244976,239.234375,131,52,183,
3,248844,243.0117188,131,36,167,
3,252710,246.7871094,963,888,1851,
3,256570,250.5566406,124,62,186,
3,260438,254.3339844,137,32,169,
3,264310,258.1152344,139,63,202,
3,268176,261.890625,116,39,155,
3,272054,265.6777344,124,32,156,
3,275924,269.4570313,115,41,156,
3,279796,273.2382813,102,32,134,
3,283672,277.0234375,125,63,188,
3,287548,280.8085938,100,33,133,
3,291434,284.6035156,2117,2040,4157,
3,295318,288.3964844,288,27,315,
3,299204,292.1914063,323,48,371,
3,303082,295.9785156,306,29,335,
3,306958,299.7636719,135,34,169,
3,310836,303.5507813,177,49,226,
3,314718,307.3417969,143,49,192,
3,318588,311.1210938,171,69,240,
3,322468,314.9101563,104,36,140,
3,326354,318.7050781,2086,2014,4100,
3,330238,322.4980469,440,24,464,
3,334108,326.2773438,1561,1472,3033,
3,337992,330.0703125,1001,853,1854,
3,341866,333.8535156,658,576,1234,
3,345744,337.640625,746,651,1397,
3,349630,341.4355469,448,370,818,
3,353512,345.2265625,718,633,1351,
3,357388,349.0117188,441,352,793,
3,361270,352.8027344,690,518,1208,
3,365152,356.59375,606,505,1111,
3,369022,360.3730469,599,514,1113,
3,372906,364.1660156,590,403,993,
3,376792,367.9609375,655,560,1215,
3,380668,371.7460938,639,539,1178,
3,384548,375.5351563,662,577,1239,
3,388418,379.3144531,610,516,1126,
3,392292,383.0976563,749,580,1329,
3,396150,386.8652344,578,501,1079,
3,400038,390.6621094,667,573,1240,
3,403906,394.4394531,670,588,1258,
3,407780,398.2226563,545,459,1004,
3,411652,402.0039063,647,559,1206,
3,415524,405.7851563,700,598,1298,
3,419402,409.5722656,700,599,1299,
3,423278,413.3574219,769,686,1455,
3,427156,417.1445313,686,587,1273,
3,431026,420.9238281,539,448,987,
3,434898,424.7050781,717,621,1338,
3,438780,428.4960938,717,627,1344,
3,442654,432.2792969,698,617,1315,
3,447244,436.7617188,768,661,1429,
3,451828,441.2382813,1044,954,1998,
3,456406,445.7089844,779,679,1458,
3,460976,450.171875,1653,648,2301,
3,465564,454.6523438,1249,122,1371,
3,470130,459.1113281,877,578,1455,
3,473994,462.8847656,520,403,923,
3,477876,466.6757813,515,423,938,
3,481754,470.4628906,701,603,1304,
3,485630,474.2480469,690,579,1269,
3,489508,478.0351563,647,550,1197,
3,493394,481.8300781,724,630,1354,
3,497260,485.6054688,691,590,1281,
3,501132,489.3867188,801,540,1341,
3,505006,493.1699219,664,526,1190,
3,508884,496.9570313,755,550,1305,
3,512766,500.7480469,767,661,1428,
3,516648,504.5390625,783,679,1462,
3,520516,508.3164063,530,424,954,
3,524404,512.1132813,737,639,1376,
3,528286,515.9042969,780,659,1439,
3,532148,519.6757813,711,594,1305,
3,536034,523.4707031,780,659,1439,
3,539908,527.2539063,716,614,1330,
3,543782,531.0371094,855,742,1597,
3,547652,534.8164063,806,517,1323,
3,551546,538.6191406,1085,977,2062,
3,555440,542.421875,1399,424,1823,
3,559318,546.2089844,639,522,1161,
3,563214,550.0136719,1309,647,1956,
3,567098,553.8066406,510,356,866,
3,570978,557.5957031,1101,438,1539,
3,574852,561.3789063,619,509,1128,
3,578728,565.1640625,937,810,1747,
3,582608,568.953125,674,563,1237,
3,586480,572.734375,1002,884,1886,
3,590352,576.515625,784,654,1438,
3,594238,580.3105469,1002,862,1864,
3,598116,584.0976563,1033,901,1934,
3,601994,587.8847656,742,589,1331,
3,605870,591.6699219,912,773,1685,
3,609752,595.4609375,715,585,1300,
3,613616,599.234375,957,842,1799,
3,617492,603.0195313,686,564,1250,
3,621362,606.7988281,904,787,1691,
3,625230,610.5761719,749,624,1373,
3,629106,614.3613281,986,871,1857,
3,632968,618.1328125,789,652,1441,
3,636836,621.9101563,1000,880,1880,
3,640706,625.6894531,922,773,1695,
3,644584,629.4765625,716,573,1289,
3,648462,633.2636719,1132,893,2025,
3,652328,637.0390625,862,706,1568,
3,656198,640.8183594,769,618,1387,
3,660066,644.5957031,685,534,1219,
3,663942,648.3808594,753,604,1357,
3,667814,652.1621094,782,646,1428,
3,671692,655.9492188,700,577,1277,
3,675586,659.7519531,957,726,1683,
3,679482,663.5566406,778,646,1424,
3,683354,667.3378906,732,589,1321,
3,687234,671.1269531,707,553,1260,
3,691106,674.9082031,633,516,1149,
3,694974,678.6855469,864,670,1534,
3,698848,682.46875,654,519,1173,
3,702722,686.2519531,918,732,1650,BAn20m15 (iteration 3)
3,4666,4.556640625,104,36,140,
3,8542,8.341796875,100,30,130,
3,12410,12.11914063,111,35,146,
3,16286,15.90429688,106,23,129,
3,20178,19.70507813,116,35,151,
3,24056,23.4921875,95,19,114,
3,27922,27.26757813,122,35,157,
3,31808,31.0625,133,46,179,
3,35694,34.85742188,92,23,115,
3,39570,38.64257813,114,19,133,
3,43444,42.42578125,131,34,165,
3,47318,46.20898438,125,35,160,
3,51188,49.98828125,117,36,153,
3,55066,53.77539063,132,34,166,
3,58944,57.5625,145,48,193,
3,62828,61.35546875,143,24,167,
3,66712,65.1484375,162,52,214,
3,70584,68.9296875,139,29,168,
3,74480,72.734375,138,41,179,
3,78366,76.52929688,90,34,124,
3,82250,80.32226563,117,38,155,
3,86132,84.11328125,162,51,213,
3,89996,87.88671875,80,23,103,
3,93864,91.6640625,84,22,106,
3,97746,95.45507813,103,34,137,
3,101616,99.234375,112,34,146,
3,105484,103.0117188,118,34,152,
3,109358,106.7949219,235,51,286,
3,113238,110.5839844,231,70,301,
3,117110,114.3652344,127,70,197,
3,120982,118.1464844,101,39,140,
3,124850,121.9238281,103,47,150,
3,128744,125.7265625,147,45,192,
3,132616,129.5078125,177,42,219,
3,136492,133.2929688,116,32,148,
3,140374,137.0839844,89,16,105,
3,144268,140.8867188,84,17,101,
3,148150,144.6777344,80,36,116,
3,152028,148.4648438,91,33,124,
3,155910,152.2558594,136,67,203,
3,159794,156.0488281,142,65,207,
3,163660,159.8242188,131,73,204,
3,167530,163.6035156,410,141,551,
3,171394,167.3769531,1657,1478,3135,
3,175270,171.1621094,2321,2175,4496,
3,179148,174.9492188,217,78,295,
3,183024,178.734375,170,26,196,
3,186908,182.5273438,212,18,230,
3,190788,186.3164063,705,579,1284,
3,194678,190.1152344,381,235,616,
3,198546,193.8925781,195,18,213,
3,202420,197.6757813,236,72,308,
3,206312,201.4765625,201,47,248,
3,210176,205.25,254,96,350,
3,214044,209.0273438,220,47,267,
3,217912,212.8046875,138,24,162,
3,221792,216.59375,132,53,185,
3,225662,220.3730469,119,38,157,
3,229532,224.1523438,93,35,128,
3,233424,227.953125,97,34,131,
3,237278,231.7167969,100,34,134,
3,241148,235.4960938,1484,1362,2846,
3,245016,239.2734375,214,56,270,
3,248886,243.0527344,254,54,308,
3,252768,246.84375,299,99,398,
3,256640,250.625,135,33,168,
3,260510,254.4042969,99,36,135,
3,264398,258.2011719,125,56,181,
3,268268,261.9804688,118,42,160,
3,272160,265.78125,104,22,126,
3,276022,269.5527344,121,32,153,
3,279898,273.3378906,1096,950,2046,
3,283768,277.1171875,152,48,200,
3,287636,280.8945313,118,51,169,
3,291520,284.6875,147,88,235,
3,295398,288.4746094,200,52,252,
3,299264,292.25,184,37,221,
3,303128,296.0234375,279,39,318,
3,307006,299.8105469,300,31,331,
3,310874,303.5878906,224,33,257,
3,314766,307.3886719,2361,2283,4644,
3,318640,311.171875,196,110,306,
3,322522,314.9628906,128,54,182,
3,326388,318.7382813,185,112,297,
3,330262,322.5214844,2071,1820,3891,
3,334136,326.3046875,139,38,177,
3,338010,330.0878906,1416,1315,2731,
3,341896,333.8828125,1435,1316,2751,
3,345772,337.6679688,558,432,990,
3,349644,341.4492188,485,356,841,
3,353508,345.2226563,812,656,1468,
3,357378,349.0019531,586,383,969,
3,361252,352.7851563,640,451,1091,
3,365144,356.5859375,662,423,1085,
3,369024,360.375,586,492,1078,
3,372892,364.1523438,636,527,1163,
3,376768,367.9375,485,246,731,
3,380644,371.7226563,601,468,1069,
3,384512,375.5,817,561,1378,
3,388398,379.2949219,772,638,1410,
3,392286,383.0917969,735,444,1179,
3,396142,386.8574219,656,227,883,
3,400018,390.6425781,816,504,1320,
3,403908,394.4414063,401,296,697,
3,407790,398.2324219,701,603,1304,
3,411664,402.015625,733,625,1358,
3,415546,405.8066406,695,492,1187,
3,419436,409.6054688,765,402,1167,
3,423312,413.390625,913,804,1717,
3,427194,417.1816406,699,608,1307,
3,431074,420.9707031,825,707,1532,
3,434942,424.7480469,705,606,1311,
3,438818,428.5332031,703,588,1291,
3,442692,432.3164063,815,731,1546,
3,447270,436.7871094,806,663,1469,
3,451842,441.2519531,871,743,1614,
3,456420,445.7226563,1107,1023,2130,
3,461002,450.1972656,1329,788,2117,
3,465580,454.6679688,1032,388,1420,
3,470166,459.1464844,1030,469,1499,
3,474038,462.9277344,626,150,776,
3,477922,466.7207031,438,326,764,
3,481796,470.5039063,614,515,1129,
3,485688,474.3046875,601,514,1115,
3,489560,478.0859375,770,676,1446,
3,493436,481.8710938,839,732,1571,
3,497330,485.6738281,651,569,1220,
3,501214,489.4667969,748,624,1372,
3,505104,493.265625,632,507,1139,
3,508990,497.0605469,716,625,1341,
3,512870,500.8496094,521,418,939,
3,516734,504.6230469,764,658,1422,
3,520626,508.4238281,639,546,1185,
3,524508,512.2148438,816,704,1520,
3,528364,515.9804688,701,577,1278,
3,532236,519.7617188,1243,1119,2362,
3,536122,523.5566406,841,713,1554,
3,540004,527.3476563,721,607,1328,
3,543876,531.1289063,801,707,1508,
3,547754,534.9160156,601,505,1106,
3,551628,538.6992188,872,756,1628,
3,555498,542.4785156,634,527,1161,
3,559374,546.2636719,811,708,1519,
3,563268,550.0664063,786,675,1461,
3,567144,553.8515625,764,654,1418,
3,571014,557.6308594,807,689,1496,
3,574894,561.4199219,711,609,1320,
3,578778,565.2128906,763,632,1395,
3,582654,568.9980469,793,685,1478,
3,586546,572.7988281,881,772,1653,
3,590428,576.5898438,708,548,1256,
3,594304,580.375,799,654,1453,
3,598172,584.1523438,838,724,1562,
3,602050,587.9394531,848,723,1571,
3,605930,591.7285156,668,530,1198,
3,609810,595.5175781,876,736,1612,
3,613674,599.2910156,781,643,1424,
3,617554,603.0800781,816,705,1521,
3,621424,606.859375,705,599,1304,
3,625304,610.6484375,832,692,1524,
3,629178,614.4316406,935,788,1723,
3,633070,618.2324219,837,727,1564,
3,636946,622.0175781,646,530,1176,
3,640822,625.8027344,983,849,1832,
3,644700,629.5898438,1032,920,1952,
3,648570,633.3691406,677,526,1203,
3,652440,637.1484375,700,542,1242,
3,656322,640.9394531,665,475,1140,
3,660196,644.7226563,766,594,1360,
3,664058,648.4941406,656,523,1179,
3,667934,652.2792969,665,528,1193,
3,671810,656.0644531,717,578,1295,
3,675698,659.8613281,687,545,1232,
3,679562,663.6347656,880,703,1583,
3,683446,667.4277344,664,514,1178,
3,687318,671.2089844,671,522,1193,
3,691196,674.9960938,689,518,1207,
3,695066,678.7753906,708,532,1240,
3,698938,682.5566406,663,506,1169,
3,702816,686.34375,745,559,1304,BAn20m15 (iteration 4)
3,4664,4.5546875,82,36,118,
3,8534,8.333984375,100,29,129,
3,12408,12.1171875,89,36,125,
3,16276,15.89453125,91,35,126,
3,20142,19.66992188,115,47,162,
3,24026,23.46289063,81,35,116,
3,27902,27.24804688,65,19,84,
3,31770,31.02539063,70,19,89,
3,35658,34.82226563,86,18,104,
3,39528,38.6015625,122,30,152,
3,43394,42.37695313,99,19,118,
3,47272,46.1640625,122,24,146,
3,51154,49.95507813,126,35,161,
3,55026,53.73632813,128,38,166,
3,58898,57.51757813,102,35,137,
3,62766,61.29492188,84,19,103,
3,66648,65.0859375,83,34,117,
3,70520,68.8671875,88,18,106,
3,74398,72.65429688,77,34,111,
3,78276,76.44140625,77,17,94,
3,82172,80.24609375,77,19,96,
3,86056,84.0390625,85,22,107,
3,89928,87.8203125,69,18,87,
3,93790,91.59179688,69,14,83,
3,97668,95.37890625,69,19,88,
3,101548,99.16796875,82,33,115,
3,105444,102.9726563,136,50,186,
3,109310,106.7480469,100,29,129,
3,113196,110.5429688,169,76,245,
3,117084,114.3398438,142,73,215,
3,120954,118.1191406,112,29,141,
3,124834,121.9082031,74,17,91,
3,128722,125.7050781,84,30,114,
3,132594,129.4863281,116,60,176,
3,136476,133.2773438,73,32,105,
3,140330,137.0410156,79,17,96,
3,144206,140.8261719,85,18,103,
3,148086,144.6152344,83,16,99,
3,151972,148.4101563,99,23,122,
3,155842,152.1894531,85,36,121,
3,159708,155.9648438,69,24,93,
3,163586,159.7519531,129,64,193,
3,167468,163.5429688,1746,1476,3222,
3,171322,167.3066406,936,736,1672,
3,175194,171.0878906,460,346,806,
3,179066,174.8691406,1269,1054,2323,
3,182954,178.6660156,276,44,320,
3,186826,182.4472656,265,155,420,
3,190706,186.2363281,516,401,917,
3,194584,190.0234375,281,194,475,
3,198458,193.8066406,283,220,503,
3,202330,197.5878906,316,238,554,
3,206210,201.3769531,96,33,129,
3,210068,205.1445313,153,88,241,
3,213936,208.921875,120,32,152,
3,217822,212.7167969,184,18,202,
3,221706,216.5097656,254,61,315,
3,225584,220.296875,849,638,1487,
3,229454,224.0761719,240,36,276,
3,233334,227.8652344,101,18,119,
3,237208,231.6484375,100,35,135,
3,241078,235.4277344,131,52,183,
3,244948,239.2070313,116,49,165,
3,248834,243.0019531,284,191,475,
3,252718,246.7949219,217,121,338,
3,256600,250.5859375,112,26,138,
3,260482,254.3769531,158,66,224,
3,264342,258.1464844,1321,1251,2572,
3,268226,261.9394531,108,33,141,
3,272098,265.7207031,103,41,144,
3,275962,269.4941406,358,273,631,
3,279834,273.2753906,119,37,156,
3,283704,277.0546875,181,101,282,
3,287582,280.8417969,146,56,202,
3,291454,284.6230469,185,97,282,
3,295324,288.4023438,209,91,300,
3,299204,292.1914063,437,48,485,
3,303066,295.9628906,985,780,1765,
3,306944,299.75,114,26,140,
3,310818,303.5332031,185,88,273,
3,314700,307.3242188,121,37,158,
3,318582,311.1152344,169,97,266,
3,322452,314.8945313,353,225,578,
3,326326,318.6777344,406,221,627,
3,330208,322.46875,1875,1128,3003,
3,334090,326.2597656,2254,1819,4073,
3,337974,330.0527344,784,341,1125,
3,341850,333.8378906,932,451,1383,
3,345728,337.625,479,225,704,
3,349604,341.4101563,416,323,739,
3,353496,345.2109375,653,534,1187,
3,357376,349,709,582,1291,
3,361258,352.7910156,665,506,1171,
3,365138,356.5800781,667,479,1146,
3,369010,360.3613281,852,488,1340,
3,372888,364.1484375,1072,155,1227,
3,376772,367.9414063,649,116,765,
3,380644,371.7226563,884,97,981,
3,384522,375.5097656,952,210,1162,
3,388408,379.3046875,678,56,734,
3,392288,383.09375,313,194,507,
3,396162,386.8769531,597,498,1095,
3,400036,390.6601563,632,484,1116,
3,403916,394.4492188,731,523,1254,
3,407790,398.2324219,721,614,1335,
3,411656,402.0078125,623,526,1149,
3,415530,405.7910156,755,663,1418,
3,419408,409.578125,1003,896,1899,
3,423300,413.3789063,2231,1927,4158,
3,427178,417.1660156,884,779,1663,
3,431070,420.9667969,223,129,352,
3,434938,424.7441406,715,605,1320,
3,438800,428.515625,521,424,945,
3,442680,432.3046875,812,719,1531,
3,447258,436.7753906,607,493,1100,
3,451838,441.2480469,981,872,1853,
3,456422,445.7246094,885,778,1663,
3,460994,450.1894531,1537,580,2117,
3,465566,454.6542969,1366,266,1632,
3,470136,459.1171875,1182,601,1783,
3,474012,462.9023438,520,397,917,
3,477896,466.6953125,497,367,864,
3,481770,470.4785156,841,717,1558,
3,485658,474.2753906,670,548,1218,
3,489530,478.0566406,693,587,1280,
3,493406,481.8417969,788,683,1471,
3,497276,485.6210938,617,525,1142,
3,501144,489.3984375,800,684,1484,
3,505010,493.1738281,548,446,994,
3,508888,496.9609375,764,661,1425,
3,512766,500.7480469,761,660,1421,
3,516640,504.53125,517,410,927,
3,520530,508.3300781,834,713,1547,
3,524412,512.1210938,798,684,1482,
3,528296,515.9140625,655,543,1198,
3,532170,519.6972656,879,742,1621,
3,536030,523.4667969,849,728,1577,
3,539906,527.2519531,907,777,1684,
3,543784,531.0390625,661,551,1212,
3,547666,534.8300781,837,728,1565,
3,551554,538.6269531,740,626,1366,
3,555424,542.40625,1038,898,1936,
3,559282,546.1738281,940,817,1757,
3,563162,549.9628906,704,568,1272,
3,567024,553.734375,831,703,1534,
3,570892,557.5117188,826,706,1532,
3,574770,561.2988281,671,560,1231,
3,578644,565.0820313,964,847,1811,
3,582514,568.8613281,762,634,1396,
3,586402,572.6582031,864,745,1609,
3,590278,576.4433594,1803,1622,3425,
3,594138,580.2128906,432,298,730,
3,598016,584,700,540,1240,
3,601896,587.7890625,990,826,1816,
3,605772,591.5742188,825,700,1525,
3,609650,595.3613281,906,787,1693,
3,613516,599.1367188,687,565,1252,
3,617390,602.9199219,980,838,1818,
3,621272,606.7109375,1098,970,2068,
3,625150,610.4980469,712,588,1300,
3,629018,614.2753906,889,767,1656,
3,632902,618.0683594,725,597,1322,
3,636780,621.8554688,955,809,1764,
3,640648,625.6328125,708,583,1291,
3,644506,629.4003906,1086,943,2029,
3,648396,633.1992188,841,686,1527,
3,652276,636.9882813,771,603,1374,
3,656164,640.7851563,789,630,1419,
3,660026,644.5566406,879,706,1585,
3,663900,648.3398438,688,554,1242,
3,667774,652.1230469,745,619,1364,
3,671654,655.9121094,840,712,1552,
3,675528,659.6953125,821,675,1496,
3,679400,663.4765625,692,564,1256,
3,683274,667.2597656,833,641,1474,
3,687144,671.0390625,724,590,1314,
3,691014,674.8183594,717,566,1283,
3,694900,678.6132813,741,590,1331,
3,698782,682.4042969,1068,889,1957,
3,702660,686.1914063,688,548,1236,BAn20m5 (iteration 5)
6,10254,10.01367188,132,70,202,
6,19736,19.2734375,169,99,268,
6,29216,28.53125,143,64,207,
6,38700,37.79296875,124,65,189,
6,48164,47.03515625,124,69,193,
6,57640,56.2890625,124,67,191,
6,67106,65.53320313,126,72,198,
6,76582,74.78710938,138,71,209,
6,86058,84.04101563,124,64,188,
6,95524,93.28515625,109,54,163,
6,104984,102.5234375,132,67,199,
6,114466,111.7832031,142,74,216,
6,123926,121.0214844,139,71,210,
6,133402,130.2753906,134,68,202,
6,142878,139.5292969,162,79,241,
6,152344,148.7734375,417,356,773,
6,161812,158.0195313,171,92,263,
6,171282,167.2675781,157,80,237,
6,180764,176.5273438,201,87,288,
6,190252,185.7929688,949,875,1824,
6,199734,195.0527344,167,90,257,
6,209210,204.3066406,136,61,197,
6,218690,213.5644531,151,81,232,
6,228174,222.8261719,723,633,1356,
6,237652,232.0820313,152,66,218,
6,247120,241.328125,213,107,320,
6,256592,250.578125,634,502,1136,
6,266076,259.8398438,176,75,251,
6,275550,269.0917969,200,89,289,
6,285034,278.3535156,220,85,305,
6,294496,287.59375,187,104,291,
6,303976,296.8515625,181,84,265,
6,313444,306.0976563,215,99,314,
6,322910,315.3417969,183,76,259,
6,332398,324.6074219,1497,1385,2882,
6,341874,333.8613281,569,459,1028,
6,351352,343.1171875,532,444,976,BAn20m2 (iteration 1)
6,10280,10.0390625,112,69,181,
6,19760,19.296875,137,87,224,
6,29242,28.55664063,143,80,223,
6,38712,37.8046875,124,63,187,
6,48188,47.05859375,108,66,174,
6,57672,56.3203125,114,53,167,
6,67134,65.56054688,113,63,176,
6,76626,74.83007813,115,56,171,
6,86098,84.08007813,136,68,204,
6,95566,93.32617188,125,54,179,
6,105030,102.5683594,118,57,175,
6,114520,111.8359375,124,64,188,
6,123978,121.0722656,189,124,313,
6,133458,130.3300781,143,73,216,
6,142950,139.5996094,209,97,306,
6,152454,148.8808594,148,64,212,
6,161936,158.140625,162,98,260,
6,171400,167.3828125,133,68,201,
6,180892,176.6523438,132,67,199,
6,190368,185.90625,220,118,338,
6,199852,195.1679688,209,100,309,
6,209326,204.4199219,238,126,364,
6,218814,213.6855469,437,364,801,
6,228290,222.9394531,148,67,215,
6,237750,232.1777344,149,84,233,
6,247226,241.4316406,157,66,223,
6,256706,250.6894531,599,507,1106,
6,266188,259.9492188,154,72,226,
6,275670,269.2089844,137,67,204,
6,285136,278.453125,141,63,204,
6,294608,287.703125,179,101,280,
6,304098,296.9707031,167,78,245,
6,313568,306.21875,144,66,210,
6,323040,315.46875,241,135,376,
6,332524,324.7304688,1133,1030,2163,
6,342004,333.9882813,1437,1355,2792,
6,351464,343.2265625,396,305,701,BAn20m2 (iteration 2)
6,10272,10.03125,120,62,182,
6,19746,19.28320313,117,67,184,
6,29232,28.546875,106,55,161,
6,38728,37.8203125,101,57,158,
6,48206,47.07617188,108,60,168,
6,57684,56.33203125,102,54,156,
6,67156,65.58203125,125,53,178,
6,76634,74.83789063,144,69,213,
6,86120,84.1015625,121,66,187,
6,95590,93.34960938,118,60,178,
6,105064,102.6015625,135,54,189,
6,114530,111.8457031,157,80,237,
6,124000,121.09375,133,65,198,
6,133472,130.34375,122,62,184,
6,142972,139.6210938,117,63,180,
6,152432,148.859375,728,673,1401,
6,161918,158.1230469,144,78,222,
6,171382,167.3652344,113,60,173,
6,180844,176.6054688,123,69,192,
6,190314,185.8535156,127,59,186,
6,199794,195.1113281,851,774,1625,
6,209264,204.359375,148,67,215,
6,218752,213.625,138,68,206,
6,228236,222.8867188,122,59,181,
6,237714,232.1425781,131,65,196,
6,247172,241.3789063,189,109,298,
6,256662,250.6464844,806,721,1527,
6,266134,259.8964844,988,917,1905,
6,275604,269.1445313,166,78,244,
6,285084,278.4023438,137,65,202,
6,294554,287.6503906,530,453,983,
6,304038,296.9121094,142,75,217,
6,313512,306.1640625,163,73,236,
6,322998,315.4277344,207,119,326,
6,332452,324.6601563,835,755,1590,
6,341932,333.9179688,588,501,1089,
6,351408,343.171875,458,383,841,BAn20m2 (iteration 3)
6,10280,10.0390625,104,61,165,
6,19758,19.29492188,122,71,193,
6,29228,28.54296875,136,66,202,
6,38694,37.78710938,249,74,323,
6,48168,47.0390625,132,78,210,
6,57646,56.29492188,121,69,190,
6,67130,65.55664063,121,70,191,
6,76608,74.8125,151,87,238,
6,86070,84.05273438,113,65,178,
6,95546,93.30664063,130,73,203,
6,105038,102.5761719,117,62,179,
6,114524,111.8398438,121,59,180,
6,123982,121.0761719,123,59,182,
6,133466,130.3378906,123,59,182,
6,142948,139.5976563,134,72,206,
6,152404,148.8320313,126,68,194,
6,161886,158.0917969,113,60,173,
6,171368,167.3515625,128,69,197,
6,180856,176.6171875,412,350,762,
6,190330,185.8691406,233,59,292,
6,199808,195.125,137,68,205,
6,209288,204.3828125,131,59,190,
6,218776,213.6484375,162,78,240,
6,228270,222.9199219,151,68,219,
6,237730,232.1582031,129,64,193,
6,247202,241.4082031,790,713,1503,
6,256670,250.6542969,143,66,209,
6,266130,259.8925781,146,69,215,
6,275604,269.1445313,1205,1125,2330,
6,285080,278.3984375,145,70,215,
6,294564,287.6601563,177,104,281,
6,304034,296.9082031,882,802,1684,
6,313504,306.15625,188,90,278,
6,322988,315.4179688,567,487,1054,
6,332460,324.6679688,650,577,1227,
6,341928,333.9140625,908,815,1723,
6,351400,343.1640625,394,315,709,BAn20m2 (iteration 4)
6,10266,10.02539063,94,55,149,
6,19744,19.28125,102,63,165,
6,29216,28.53125,130,87,217,
6,38688,37.78125,140,77,217,
6,48144,47.015625,144,85,229,
6,57616,56.265625,123,66,189,
6,67096,65.5234375,96,53,149,
6,76580,74.78515625,112,60,172,
6,86056,84.0390625,214,56,270,
6,95542,93.30273438,111,60,171,
6,105022,102.5605469,124,75,199,
6,114504,111.8203125,134,73,207,
6,123982,121.0761719,133,74,207,
6,133456,130.328125,140,84,224,
6,142928,139.578125,129,78,207,
6,152394,148.8222656,124,69,193,
6,161870,158.0761719,108,56,164,
6,171344,167.328125,991,938,1929,
6,180814,176.5761719,119,58,177,
6,190286,185.8261719,151,70,221,
6,199758,195.0761719,121,63,184,
6,209222,204.3183594,259,62,321,
6,218698,213.5722656,138,78,216,
6,228180,222.8320313,175,89,264,
6,237662,232.0917969,159,89,248,
6,247138,241.3457031,583,500,1083,
6,256624,250.609375,139,66,205,
6,266104,259.8671875,147,77,224,
6,275588,269.1289063,297,94,391,
6,285054,278.3730469,224,125,349,
6,294550,287.6464844,201,96,297,
6,304020,296.8945313,190,101,291,
6,313500,306.1523438,142,64,206,
6,322974,315.4042969,137,62,199,
6,332452,324.6601563,1032,952,1984,
6,341938,333.9238281,910,835,1745,
6,351406,343.1699219,620,546,1166,BAn20m2 (iteration 5)
6,10266,10.02539063,99,62,161,
6,19750,19.28710938,113,64,177,
6,29220,28.53515625,100,58,158,
6,38714,37.80664063,114,67,181,
6,48198,47.06835938,107,67,174,
6,57680,56.328125,96,53,149,
6,67154,65.58007813,102,59,161,
6,76636,74.83984375,115,70,185,
6,86126,84.10742188,101,59,160,
6,95602,93.36132813,282,56,338,
6,105090,102.6269531,113,64,177,
6,114562,111.8769531,113,59,172,
6,124038,121.1308594,791,731,1522,
6,133516,130.3867188,126,70,196,
6,142996,139.6445313,474,424,898,
6,152478,148.9042969,126,60,186,
6,161964,158.1679688,107,57,164,
6,171440,167.421875,127,70,197,
6,180914,176.6738281,215,58,273,
6,190386,185.9238281,117,59,176,
6,199846,195.1621094,128,72,200,
6,209328,204.421875,125,70,195,
6,218804,213.6757813,192,103,295,
6,228288,222.9375,181,93,274,
6,237784,232.2109375,155,77,232,
6,247254,241.4589844,140,67,207,
6,256720,250.703125,130,66,196,
6,266208,259.96875,554,478,1032,
6,275670,269.2089844,237,71,308,
6,285164,278.4804688,152,78,230,
6,294646,287.7402344,157,81,238,
6,304124,296.9960938,1233,1163,2396,
6,313588,306.2382813,155,74,229,
6,323066,315.4941406,150,71,221,
6,332542,324.7480469,811,735,1546,
6,342022,334.0058594,876,789,1665,
6,351494,343.2558594,811,730,1541,
6,360960,352.5,675,599,1274,
6,370434,361.7519531,501,427,928,
6,379926,371.0214844,577,504,1081,
6,389408,380.28125,559,478,1037,
6,398888,389.5390625,707,625,1332,
6,408360,398.7890625,618,529,1147,
6,417830,408.0371094,684,500,1184,
6,427316,417.3007813,639,557,1196,
6,436798,426.5605469,685,601,1286,
6,446274,435.8144531,717,622,1339,
6,455762,445.0800781,665,561,1226,
6,465240,454.3359375,765,565,1330,
6,474730,463.6035156,603,494,1097,
6,484206,472.8574219,439,315,754,
6,493690,482.1191406,393,308,701,
6,503176,491.3828125,256,162,418,
6,512644,500.6289063,820,603,1423,
6,522132,509.8945313,912,827,1739,
6,531604,519.1445313,1503,1388,2891,
6,541068,528.3867188,466,371,837,
6,550540,537.6367188,461,360,821,
6,560010,546.8847656,755,634,1389,
6,569484,556.1367188,938,771,1709,
6,578954,565.3847656,715,566,1281,
6,588436,574.6445313,962,851,1813,
6,597906,583.8925781,779,661,1440,
6,607378,593.1425781,845,584,1429,
6,616864,602.40625,723,617,1340,
6,626338,611.6582031,708,576,1284,
6,635806,620.9042969,1142,1031,2173,
6,645290,630.1660156,490,381,871,
6,654776,639.4296875,569,456,1025,
6,664262,648.6933594,1718,1560,3278,
6,673738,657.9472656,2003,1878,3881,
6,683218,667.2050781,1248,1100,2348,
6,692704,676.46875,1664,1547,3211,
6,702184,685.7265625,1316,1080,2396,
6,711666,694.9863281,1203,1089,2292,
6,721140,704.2382813,1424,1270,2694,
6,730610,713.4863281,1234,1101,2335,
6,740090,722.7441406,1367,1136,2503,
6,749564,731.9960938,1458,1211,2669,
6,759046,741.2558594,1397,1266,2663,
6,768522,750.5097656,1309,1168,2477,
6,777988,759.7539063,1488,1228,2716,
6,787470,769.0136719,1130,958,2088,
6,796950,778.2714844,1542,1338,2880,
6,806428,787.5273438,1432,1306,2738,BAn20m5 (iteration 1)
6,10278,10.03710938,97,60,157,
6,19752,19.2890625,96,52,148,
6,29224,28.5390625,98,63,161,
6,38690,37.78320313,94,56,150,
6,48162,47.03320313,95,55,150,
6,57634,56.28320313,102,57,159,
6,67108,65.53515625,98,57,155,
6,76600,74.8046875,106,63,169,
6,86084,84.06640625,97,56,153,
6,95560,93.3203125,98,54,152,
6,105046,102.5839844,117,60,177,
6,114530,111.8457031,134,83,217,
6,124006,121.0996094,145,78,223,
6,133506,130.3769531,115,67,182,
6,142978,139.6269531,2867,2800,5667,
6,152450,148.8769531,123,73,196,
6,161916,158.1210938,125,61,186,
6,171384,167.3671875,118,68,186,
6,180876,176.6367188,115,62,177,
6,190358,185.8964844,142,80,222,
6,199832,195.1484375,139,76,215,
6,209296,204.390625,469,398,867,
6,218772,213.6445313,119,63,182,
6,228250,222.9003906,148,78,226,
6,237710,232.1386719,133,60,193,
6,247192,241.3984375,133,75,208,
6,256678,250.6621094,935,861,1796,
6,266160,259.921875,132,73,205,
6,275640,269.1796875,128,66,194,
6,285118,278.4355469,138,68,206,
6,294588,287.6835938,174,85,259,
6,304056,296.9296875,1358,1273,2631,
6,313528,306.1796875,181,95,276,
6,322994,315.4238281,164,82,246,
6,332456,324.6640625,2499,2405,4904,
6,341940,333.9257813,486,391,877,
6,351402,343.1660156,718,646,1364,
6,360880,352.421875,636,563,1199,
6,370346,361.6660156,588,518,1106,
6,379818,370.9160156,651,576,1227,
6,389306,380.1816406,492,415,907,
6,398770,389.4238281,739,664,1403,
6,408238,398.6699219,603,510,1113,
6,417720,407.9296875,605,506,1111,
6,427200,417.1875,602,495,1097,
6,436696,426.4609375,270,178,448,
6,446168,435.7109375,410,323,733,
6,455660,444.9804688,952,865,1817,
6,465144,454.2421875,1034,949,1983,
6,474616,463.4921875,595,496,1091,
6,484098,472.7519531,792,704,1496,
6,493568,482,848,738,1586,
6,503052,491.2617188,825,692,1517,
6,512540,500.5273438,965,821,1786,
6,521998,509.7636719,699,524,1223,
6,531474,519.0175781,821,714,1535,
6,540960,528.28125,599,508,1107,
6,550460,537.5585938,607,476,1083,
6,559940,546.8164063,671,502,1173,
6,569408,556.0625,794,636,1430,
6,578896,565.328125,634,527,1161,
6,588386,574.5957031,933,824,1757,
6,597862,583.8496094,952,803,1755,
6,607338,593.1035156,922,764,1686,
6,616806,602.3496094,815,705,1520,
6,626280,611.6015625,1766,1580,3346,
6,635780,620.8789063,698,509,1207,
6,645254,630.1308594,537,422,959,
6,654728,639.3828125,936,826,1762,
6,664192,648.625,1830,1708,3538,
6,673666,657.8769531,1471,1334,2805,
6,683152,667.140625,1504,1342,2846,
6,692636,676.4023438,1698,1572,3270,
6,702120,685.6640625,1470,1293,2763,
6,711610,694.9316406,1226,1093,2319,
6,721082,704.1816406,1227,1078,2305,
6,730550,713.4277344,1516,1357,2873,
6,740036,722.6914063,913,754,1667,
6,749498,731.9316406,1351,1215,2566,
6,758980,741.1914063,1478,1357,2835,
6,768458,750.4472656,1027,886,1913,
6,777936,759.703125,1541,1388,2929,
6,787406,768.9511719,1525,1272,2797,
6,796880,778.203125,1390,1137,2527,
6,806364,787.4648438,1347,1182,2529,BAn20m5 (iteration 2)
6,10270,10.02929688,89,54,143,
6,19742,19.27929688,93,55,148,
6,29220,28.53515625,88,54,142,
6,38686,37.77929688,91,54,145,
6,48164,47.03515625,100,59,159,
6,57642,56.29101563,104,61,165,
6,67116,65.54296875,99,56,155,
6,76588,74.79296875,106,58,164,
6,86060,84.04296875,118,67,185,
6,95542,93.30273438,108,60,168,
6,105010,102.5488281,111,65,176,
6,114474,111.7910156,93,54,147,
6,123954,121.0488281,2334,2281,4615,
6,133424,130.296875,737,690,1427,
6,142906,139.5566406,107,57,164,
6,152384,148.8125,110,55,165,
6,161852,158.0585938,111,63,174,
6,171318,167.3027344,172,103,275,
6,180792,176.5546875,175,92,267,
6,190268,185.8085938,182,91,273,
6,199764,195.0820313,523,454,977,
6,209232,204.328125,136,67,203,
6,218706,213.5800781,587,530,1117,
6,228180,222.8320313,127,68,195,
6,237648,232.078125,123,60,183,
6,247122,241.3300781,150,70,220,
6,256602,250.5878906,1053,968,2021,
6,266074,259.8378906,286,210,496,
6,275562,269.1035156,371,312,683,
6,285050,278.3691406,125,65,190,
6,294532,287.6289063,1977,1890,3867,
6,304010,296.8847656,155,72,227,
6,313478,306.1308594,156,65,221,
6,322952,315.3828125,172,77,249,
6,332424,324.6328125,1033,956,1989,
6,341902,333.8886719,217,146,363,
6,351380,343.1445313,881,809,1690,
6,360868,352.4101563,1109,1038,2147,
6,370344,361.6640625,1108,1031,2139,
6,379820,370.9179688,618,517,1135,
6,389282,380.1582031,958,843,1801,
6,398778,389.4316406,735,621,1356,
6,408254,398.6855469,807,709,1516,
6,417722,407.9316406,518,444,962,
6,427202,417.1894531,799,711,1510,
6,436674,426.4394531,1173,1093,2266,
6,446148,435.6914063,281,196,477,
6,455640,444.9609375,594,515,1109,
6,465136,454.234375,785,699,1484,
6,474626,463.5019531,592,513,1105,
6,484098,472.7519531,909,815,1724,
6,493576,482.0078125,868,772,1640,
6,503046,491.2558594,968,878,1846,
6,512522,500.5097656,570,484,1054,
6,521986,509.7519531,849,754,1603,
6,531452,518.9960938,1058,955,2013,
6,540928,528.25,390,295,685,
6,550416,537.515625,471,375,846,
6,559898,546.7753906,642,534,1176,
6,569372,556.0273438,591,476,1067,
6,578854,565.2871094,850,735,1585,
6,588338,574.5488281,936,833,1769,
6,597808,583.796875,893,790,1683,
6,607286,593.0527344,919,776,1695,
6,616776,602.3203125,725,616,1341,
6,626246,611.5683594,896,767,1663,
6,635720,620.8203125,1108,895,2003,
6,645210,630.0878906,930,746,1676,
6,654686,639.3417969,822,634,1456,
6,664172,648.6054688,1967,1799,3766,
6,673646,657.8574219,1871,1754,3625,
6,683144,667.1328125,1714,1586,3300,
6,692628,676.3945313,1244,1103,2347,
6,702108,685.6523438,1785,1660,3445,
6,711582,694.9042969,1525,1400,2925,
6,721058,704.1582031,1273,1127,2400,
6,730540,713.4179688,1258,1116,2374,
6,740018,722.6738281,1371,1241,2612,
6,749482,731.9160156,1123,970,2093,
6,758946,741.1582031,1484,1253,2737,
6,768428,750.4179688,1214,1065,2279,
6,777910,759.6777344,1352,1215,2567,
6,787384,768.9296875,1275,1131,2406,
6,796862,778.1855469,1208,1058,2266,
6,806326,787.4277344,1076,920,1996,BAn20m5 (iteration 3)
6,10276,10.03515625,111,75,186,
6,19748,19.28515625,154,94,248,
6,29236,28.55078125,141,89,230,
6,38712,37.8046875,132,81,213,
6,48186,47.05664063,102,59,161,
6,57678,56.32617188,130,77,207,
6,67136,65.5625,96,55,151,
6,76614,74.81835938,107,65,172,
6,86086,84.06835938,122,77,199,
6,95562,93.32226563,106,55,161,
6,105030,102.5683594,102,55,157,
6,114504,111.8203125,129,75,204,
6,123988,121.0820313,129,63,192,
6,133470,130.3417969,152,70,222,
6,142952,139.6015625,126,66,192,
6,152442,148.8691406,132,71,203,
6,161918,158.1230469,120,64,184,
6,171410,167.3925781,164,99,263,
6,180896,176.65625,1937,1867,3804,
6,190370,185.9082031,649,576,1225,
6,199838,195.1542969,326,255,581,
6,209306,204.4003906,363,285,648,
6,218778,213.6503906,666,579,1245,
6,228262,222.9121094,133,65,198,
6,237726,232.1542969,137,63,200,
6,247202,241.4082031,677,597,1274,
6,256672,250.65625,153,79,232,
6,266146,259.9082031,491,402,893,
6,275640,269.1796875,129,69,198,
6,285114,278.4316406,139,73,212,
6,294594,287.6894531,644,581,1225,
6,304062,296.9355469,152,85,237,
6,313532,306.1835938,135,68,203,
6,323008,315.4375,132,63,195,
6,332482,324.6894531,990,925,1915,
6,341956,333.9414063,1092,1011,2103,
6,351416,343.1796875,933,852,1785,
6,360890,352.4316406,975,903,1878,
6,370374,361.6933594,578,500,1078,
6,379848,370.9453125,756,674,1430,
6,389334,380.2089844,507,422,929,
6,398824,389.4765625,682,605,1287,
6,408308,398.7382813,1454,1350,2804,
6,417780,407.9882813,547,470,1017,
6,427256,417.2421875,488,413,901,
6,436744,426.5078125,832,738,1570,
6,446210,435.7519531,530,454,984,
6,455686,445.0058594,722,641,1363,
6,465168,454.265625,542,459,1001,
6,474646,463.5214844,1048,954,2002,
6,484126,472.7792969,795,701,1496,
6,493608,482.0390625,801,711,1512,
6,503092,491.3007813,606,496,1102,
6,512566,500.5527344,806,717,1523,
6,522052,509.8164063,844,749,1593,
6,531528,519.0703125,577,493,1070,
6,540998,528.3183594,1080,932,2012,
6,550486,537.5839844,869,765,1634,
6,559958,546.8339844,870,770,1640,
6,569428,556.0820313,635,541,1176,
6,578900,565.3320313,868,762,1630,
6,588366,574.5761719,630,528,1158,
6,597846,583.8339844,945,849,1794,
6,607328,593.09375,703,557,1260,
6,616812,602.3554688,1247,1061,2308,
6,626280,611.6015625,914,736,1650,
6,635744,620.84375,789,577,1366,
6,645224,630.1015625,958,761,1719,
6,654696,639.3515625,884,732,1616,
6,664182,648.6152344,2097,1978,4075,
6,673664,657.875,1883,1678,3561,
6,683142,667.1308594,1501,1301,2802,
6,692616,676.3828125,1501,1300,2801,
6,702108,685.6523438,1475,1281,2756,
6,711586,694.9082031,1514,1377,2891,
6,721076,704.1757813,1612,1400,3012,
6,730548,713.4257813,1530,1405,2935,
6,740030,722.6855469,1476,1347,2823,
6,749492,731.9257813,1603,1461,3064,
6,758980,741.1914063,1486,1356,2842,
6,768454,750.4433594,1286,1157,2443,
6,777932,759.6992188,1952,1813,3765,
6,787408,768.953125,1399,1264,2663,
6,796878,778.2011719,1328,1212,2540,
6,806362,787.4628906,1701,1562,3263,
6,815854,796.7324219,1569,1424,2993,
6,825308,805.9648438,1662,1496,3158,
6,834778,815.2128906,1589,1431,3020,
6,844246,824.4589844,1422,1263,2685,
6,853718,833.7089844,1557,1393,2950,
6,863200,842.96875,1884,1702,3586,
6,872678,852.2246094,1625,1343,2968,
6,882156,861.4804688,1613,1423,3036,
6,891636,870.7382813,1668,1519,3187,
6,901102,879.9824219,1686,1524,3210,
6,910570,889.2285156,1642,1500,3142,
6,920042,898.4785156,1637,1494,3131,
6,929526,907.7402344,1690,1432,3122,
6,939018,917.0097656,1124,949,2073,
6,948506,926.2753906,1773,1579,3352,
6,957982,935.5292969,1395,1221,2616,
6,967456,944.78125,1562,1399,2961,
6,976932,954.0351563,1178,975,2153,
6,986408,963.2890625,1804,1542,3346,
6,995888,972.546875,1149,975,2124,
6,1005372,981.8085938,2905,2714,5619,
6,1014848,991.0625,2121,1924,4045,
6,1024332,1000.324219,2217,1990,4207,
6,1033830,1009.599609,2199,1827,4026,
6,1043310,1018.857422,2047,1826,3873,
6,1052794,1028.119141,2108,1917,4025,
6,1062268,1037.371094,2106,1915,4021,BAn20m7 (iteration 1)
6,10268,10.02734375,100,62,162,
6,19736,19.2734375,92,56,148,
6,29218,28.53320313,100,67,167,
6,38686,37.77929688,102,62,164,
6,48166,47.03710938,129,82,211,
6,57644,56.29296875,113,66,179,
6,67128,65.5546875,99,59,158,
6,76616,74.8203125,123,73,196,
6,86096,84.078125,119,61,180,
6,95574,93.33398438,115,55,170,
6,105056,102.59375,123,65,188,
6,114540,111.8554688,124,58,182,
6,124022,121.1152344,139,65,204,
6,133504,130.375,125,61,186,
6,142998,139.6464844,121,70,191,
6,152466,148.8925781,112,63,175,
6,161942,158.1464844,135,61,196,
6,171418,167.4003906,5633,5581,11214,
6,180904,176.6640625,114,59,173,
6,190378,185.9160156,115,64,179,
6,199846,195.1621094,133,72,205,
6,209328,204.421875,118,62,180,
6,218816,213.6875,846,782,1628,
6,228292,222.9414063,196,140,336,
6,237770,232.1972656,184,98,282,
6,247260,241.4648438,1003,895,1898,
6,256726,250.7089844,211,85,296,
6,266198,259.9589844,777,657,1434,
6,275670,269.2089844,135,64,199,
6,285156,278.4726563,201,117,318,
6,294622,287.7167969,179,110,289,
6,304108,296.9804688,132,64,196,
6,313584,306.234375,137,65,202,
6,323058,315.4863281,131,66,197,
6,332528,324.734375,720,653,1373,
6,342008,333.9921875,1191,1105,2296,
6,351492,343.2539063,920,851,1771,
6,360956,352.4960938,903,833,1736,
6,370428,361.7460938,490,414,904,
6,379906,371.0019531,778,705,1483,
6,389378,380.2519531,619,540,1159,
6,398858,389.5097656,842,770,1612,
6,408326,398.7558594,750,674,1424,
6,417792,408,1012,922,1934,
6,427270,417.2558594,942,864,1806,
6,436756,426.5195313,680,588,1268,
6,446236,435.7773438,911,834,1745,
6,455708,445.0273438,867,789,1656,
6,465190,454.2871094,552,476,1028,
6,474664,463.5390625,985,894,1879,
6,484128,472.78125,814,726,1540,
6,493610,482.0410156,934,789,1723,
6,503082,491.2910156,704,569,1273,
6,512564,500.5507813,857,714,1571,
6,522040,509.8046875,922,786,1708,
6,531512,519.0546875,667,568,1235,
6,540984,528.3046875,902,766,1668,
6,550466,537.5644531,966,863,1829,
6,559948,546.8242188,1020,910,1930,
6,569420,556.0742188,649,541,1190,
6,578904,565.3359375,1026,931,1957,
6,588392,574.6015625,719,617,1336,
6,597876,583.8632813,1026,887,1913,
6,607362,593.1269531,647,535,1182,
6,616832,602.375,924,806,1730,
6,626308,611.6289063,934,810,1744,
6,635772,620.8710938,691,562,1253,
6,645250,630.1269531,959,852,1811,
6,654724,639.3789063,763,599,1362,
6,664204,648.6367188,1867,1740,3607,
6,673686,657.8964844,1885,1756,3641,
6,683162,667.1503906,1633,1511,3144,
6,692640,676.40625,1538,1423,2961,
6,702110,685.6542969,1497,1369,2866,
6,711584,694.90625,1314,1184,2498,
6,721056,704.15625,1851,1689,3540,
6,730534,713.4121094,1514,1387,2901,
6,740028,722.6835938,1289,1148,2437,
6,749514,731.9472656,1925,1783,3708,
6,758994,741.2050781,1503,1369,2872,
6,768474,750.4628906,1324,1196,2520,
6,777954,759.7207031,1859,1725,3584,
6,787424,768.96875,1289,1170,2459,
6,796896,778.21875,1822,1694,3516,
6,806364,787.4648438,1580,1438,3018,
6,815826,796.7050781,1495,1344,2839,
6,825304,805.9609375,1318,1128,2446,
6,834788,815.2226563,1899,1616,3515,
6,844254,824.4667969,1716,1446,3162,
6,853734,833.7246094,1539,1389,2928,
6,863232,843,1562,1392,2954,
6,872710,852.2558594,1744,1579,3323,
6,882186,861.5097656,1740,1591,3331,
6,891666,870.7675781,1604,1454,3058,
6,901134,880.0136719,1628,1460,3088,
6,910616,889.2734375,1673,1488,3161,
6,920100,898.5351563,1376,1223,2599,
6,929586,907.7988281,1995,1848,3843,
6,939060,917.0507813,1459,1256,2715,
6,948536,926.3046875,1406,1210,2616,
6,958018,935.5644531,1392,1204,2596,
6,967508,944.8320313,1467,1309,2776,
6,976982,954.0839844,1466,1304,2770,
6,986464,963.34375,1416,1159,2575,
6,995948,972.6054688,1545,1362,2907,
6,1005418,981.8535156,2800,2594,5394,
6,1014890,991.1035156,2514,2300,4814,
6,1024382,1000.373047,2620,2404,5024,
6,1033860,1009.628906,2061,1868,3929,
6,1043352,1018.898438,2286,2088,4374,
6,1052810,1028.134766,2081,1899,3980,
6,1062284,1037.386719,2115,1953,4068,BAn20m7 (iteration 2)
6,10262,10.02148438,100,59,159,
6,19730,19.26757813,96,58,154,
6,29198,28.51367188,98,57,155,
6,38672,37.765625,102,65,167,
6,48140,47.01171875,108,63,171,
6,57614,56.26367188,113,73,186,
6,67086,65.51367188,125,70,195,
6,76570,74.77539063,161,90,251,
6,86026,84.00976563,187,113,300,
6,95498,93.25976563,158,91,249,
6,104964,102.5039063,178,95,273,
6,114436,111.7539063,167,81,248,
6,123920,121.015625,106,56,162,
6,133392,130.265625,155,71,226,
6,142842,139.4941406,170,87,257,
6,152322,148.7519531,170,94,264,
6,161806,158.0136719,175,95,270,
6,171278,167.2636719,6047,5959,12006,
6,180750,176.5136719,181,81,262,
6,190214,185.7558594,222,98,320,
6,199698,195.0175781,210,89,299,
6,209170,204.2675781,134,81,215,
6,218650,213.5253906,205,94,299,
6,228130,222.7832031,203,89,292,
6,237608,232.0390625,168,102,270,
6,247092,241.3007813,844,682,1526,
6,256568,250.5546875,231,92,323,
6,266050,259.8144531,964,790,1754,
6,275530,269.0722656,168,88,256,
6,284990,278.3105469,125,68,193,
6,294470,287.5683594,152,91,243,
6,303938,296.8144531,978,911,1889,
6,313424,306.078125,143,65,208,
6,322918,315.3496094,168,61,229,
6,332398,324.6074219,741,645,1386,
6,341884,333.8710938,808,737,1545,
6,351354,343.1191406,924,849,1773,
6,360822,352.3652344,931,858,1789,
6,370292,361.6132813,473,389,862,
6,379762,370.8613281,858,788,1646,
6,389242,380.1191406,489,413,902,
6,398718,389.3730469,1003,917,1920,
6,408200,398.6328125,972,891,1863,
6,417698,407.9082031,699,607,1306,
6,427186,417.1738281,351,254,605,
6,436684,426.4492188,892,805,1697,
6,446154,435.6972656,751,655,1406,
6,455634,444.9550781,1166,1085,2251,
6,465108,454.2070313,904,810,1714,
6,474578,463.4550781,559,445,1004,
6,484038,472.6933594,927,844,1771,
6,493512,481.9453125,985,901,1886,
6,502982,491.1933594,642,543,1185,
6,512458,500.4472656,919,833,1752,
6,521924,509.6914063,778,680,1458,
6,531408,518.953125,959,853,1812,
6,540882,528.2050781,817,717,1534,
6,550356,537.4570313,1253,1151,2404,
6,559832,546.7109375,1009,911,1920,
6,569308,555.9648438,628,533,1161,
6,578788,565.2226563,1042,958,2000,
6,588264,574.4765625,649,554,1203,
6,597752,583.7421875,978,884,1862,
6,607224,592.9921875,1784,1638,3422,
6,616698,602.2441406,428,289,717,
6,626168,611.4921875,578,455,1033,
6,635632,620.734375,931,814,1745,
6,645110,629.9902344,696,582,1278,
6,654590,639.2480469,1100,967,2067,
6,664070,648.5058594,2129,1986,4115,
6,673544,657.7578125,1853,1705,3558,
6,683022,667.0136719,1790,1669,3459,
6,692500,676.2695313,1541,1422,2963,
6,701982,685.5292969,1474,1315,2789,
6,711466,694.7910156,1767,1545,3312,
6,720932,704.0351563,1737,1458,3195,
6,730414,713.2949219,1704,1477,3181,
6,739886,722.5449219,1325,1197,2522,
6,749358,731.7949219,1851,1710,3561,
6,758832,741.046875,1575,1423,2998,
6,768298,750.2910156,1585,1470,3055,
6,777784,759.5546875,1758,1626,3384,
6,787258,768.8066406,1712,1583,3295,
6,796732,778.0585938,1371,1237,2608,
6,806204,787.3085938,1855,1686,3541,
6,815672,796.5546875,1274,1127,2401,
6,825152,805.8125,1791,1648,3439,
6,834624,815.0625,1522,1382,2904,
6,844106,824.3222656,1622,1458,3080,
6,853582,833.5761719,1363,1164,2527,
6,863072,842.84375,1691,1539,3230,
6,872558,852.1074219,1728,1496,3224,
6,882034,861.3613281,1622,1460,3082,
6,891498,870.6035156,1488,1330,2818,
6,900978,879.8613281,1353,1184,2537,
6,910456,889.1171875,2124,1919,4043,
6,919936,898.375,1604,1448,3052,
6,929418,907.6347656,1704,1548,3252,
6,938896,916.890625,1451,1214,2665,
6,948374,926.1464844,1392,1197,2589,
6,957856,935.40625,1364,1182,2546,
6,967338,944.6660156,1851,1673,3524,
6,976800,953.90625,1187,978,2165,
6,986286,963.1699219,1799,1597,3396,
6,995774,972.4355469,1436,1261,2697,
6,1005252,981.6914063,2691,2450,5141,
6,1014738,990.9550781,2148,1953,4101,
6,1024218,1000.212891,2324,2123,4447,
6,1033692,1009.464844,2183,1998,4181,
6,1043162,1018.712891,2198,2004,4202,
6,1052638,1027.966797,2246,2051,4297,
6,1062108,1037.214844,2271,2059,4330,
6,10270,10.02929688,113,70,183,
6,19756,19.29296875,104,60,164,
6,29220,28.53515625,107,68,175,
6,38710,37.80273438,104,63,167,
6,48190,47.06054688,112,64,176,
6,57676,56.32421875,117,78,195,
6,67168,65.59375,127,84,211,
6,76648,74.8515625,134,77,211,
6,86124,84.10546875,135,75,210,
6,95606,93.36523438,162,70,232,
6,105090,102.6269531,144,62,206,
6,114566,111.8808594,177,77,254,
6,124032,121.125,173,94,267,
6,133514,130.3847656,174,76,250,
6,142990,139.6386719,166,77,243,
6,152466,148.8925781,160,73,233,
6,161934,158.1386719,151,70,221,
6,171406,167.3886719,173,75,248,
6,180890,176.6503906,2029,1923,3952,
6,190354,185.8925781,797,656,1453,
6,199826,195.1425781,173,89,262,
6,209302,204.3964844,163,90,253,
6,218778,213.6503906,557,440,997,
6,228250,222.9003906,175,84,259,
6,237730,232.1582031,297,74,371,
6,247208,241.4140625,674,537,1211,
6,256680,250.6640625,238,83,321,
6,266152,259.9140625,778,631,1409,
6,275614,269.1542969,191,109,300,
6,285100,278.4179688,257,173,430,
6,294570,287.6660156,214,112,326,
6,304038,296.9121094,268,102,370,
6,313512,306.1640625,210,80,290,
6,322992,315.421875,130,63,193,
6,332462,324.6699219,1257,1165,2422,
6,341936,333.921875,974,891,1865,
6,351420,343.1835938,238,160,398,
6,360890,352.4316406,1449,1364,2813,
6,370366,361.6855469,521,449,970,
6,379844,370.9414063,872,794,1666,
6,389320,380.1953125,568,465,1033,
6,398790,389.4433594,802,724,1526,
6,408268,398.6992188,908,816,1724,
6,417748,407.9570313,949,872,1821,
6,427218,417.2050781,838,751,1589,
6,436686,426.4511719,603,516,1119,
6,446174,435.7167969,845,765,1610,
6,455666,444.9863281,578,466,1044,
6,465146,454.2441406,922,839,1761,
6,474628,463.5039063,955,853,1808,
6,484112,472.765625,1138,1032,2170,
6,493580,482.0117188,1032,935,1967,
6,503048,491.2578125,653,556,1209,
6,512526,500.5136719,935,809,1744,
6,522004,509.7695313,598,506,1104,
6,531478,519.0214844,952,850,1802,
6,540954,528.2753906,910,804,1714,
6,550430,537.5292969,937,838,1775,
6,559914,546.7910156,948,863,1811,
6,569394,556.0488281,631,506,1137,
6,578860,565.2929688,845,748,1593,
6,588338,574.5488281,704,613,1317,
6,597816,583.8046875,1142,1038,2180,
6,607296,593.0625,847,445,1292,
6,616776,602.3203125,1024,844,1868,
6,626258,611.5800781,1118,964,2082,
6,635734,620.8339844,845,725,1570,
6,645206,630.0839844,916,810,1726,
6,654676,639.3320313,782,665,1447,
6,664154,648.5878906,2210,2095,4305,
6,673628,657.8398438,2093,1669,3762,
6,683096,667.0859375,1575,1191,2766,
6,692588,676.3554688,1670,1530,3200,
6,702052,685.5976563,1535,1373,2908,
6,711526,694.8496094,1528,1401,2929,
6,721002,704.1035156,1615,1481,3096,
6,730486,713.3652344,1407,1238,2645,
6,739956,722.6132813,1772,1629,3401,
6,749432,731.8671875,1591,1459,3050,
6,758918,741.1308594,1566,1441,3007,
6,768394,750.3847656,1871,1748,3619,
6,777872,759.640625,1239,1104,2343,
6,787354,768.9003906,1659,1540,3199,
6,796840,778.1640625,1908,1761,3669,
6,806302,787.4042969,1346,1195,2541,
6,815780,796.6601563,1988,1828,3816,
6,825254,805.9121094,1304,1161,2465,
6,834736,815.171875,1895,1752,3647,
6,844202,824.4160156,1343,1154,2497,
6,853664,833.65625,1964,1805,3769,
6,863142,842.9121094,1276,1115,2391,
6,872636,852.1835938,2019,1844,3863,
6,882120,861.4453125,1870,1652,3522,
6,891604,870.7070313,1395,1241,2636,
6,901068,879.9492188,1973,1811,3784,
6,910536,889.1953125,1740,1589,3329,
6,920024,898.4609375,1740,1584,3324,
6,929498,907.7128906,1421,1265,2686,
6,938974,916.9667969,1724,1512,3236,
6,948448,926.21875,1087,916,2003,
6,957916,935.4648438,1403,1215,2618,
6,967402,944.7285156,1722,1541,3263,
6,976872,953.9765625,1502,1337,2839,
6,986358,963.2402344,1472,1318,2790,
6,995830,972.4902344,1556,1369,2925,
6,1005294,981.7324219,2625,2441,5066,
6,1014774,990.9902344,2025,1823,3848,
6,1024242,1000.236328,2156,1976,4132,
6,1033740,1009.511719,2129,1950,4079,
6,1043212,1018.761719,2233,2070,4303,
6,1052694,1028.021484,2175,2011,4186,
6,1062174,1037.279297,2087,1906,3993,BAn20m7 (iteration 3)
6,10260,10.01953125,149,111,260,
6,19734,19.27148438,104,62,166,
6,29220,28.53515625,96,65,161,
6,38690,37.78320313,124,85,209,
6,48164,47.03515625,101,61,162,
6,57650,56.29882813,106,69,175,
6,67122,65.54882813,101,57,158,
6,76596,74.80078125,114,65,179,
6,86072,84.0546875,143,88,231,
6,95550,93.31054688,144,83,227,
6,105010,102.5488281,296,112,408,
6,114474,111.7910156,138,64,202,
6,123958,121.0527344,112,61,173,
6,133448,130.3203125,115,65,180,
6,142930,139.5800781,155,99,254,
6,152400,148.828125,104,62,166,
6,161866,158.0722656,116,65,181,
6,171352,167.3359375,129,72,201,
6,180834,176.5957031,154,85,239,
6,190294,185.8339844,3136,2918,6054,
6,199756,195.0742188,384,178,562,
6,209246,204.3417969,1297,1163,2460,
6,218716,213.5898438,461,247,708,
6,228194,222.8457031,229,67,296,
6,237676,232.1054688,126,69,195,
6,247152,241.359375,138,85,223,
6,256626,250.6113281,139,70,209,
6,266108,259.8710938,685,609,1294,
6,275582,269.1230469,511,453,964,
6,285052,278.3710938,242,152,394,
6,294522,287.6191406,133,64,197,
6,304016,296.890625,895,811,1706,
6,313496,306.1484375,971,799,1770,
6,322968,315.3984375,685,583,1268,
6,332446,324.6542969,657,565,1222,
6,341916,333.9023438,584,496,1080,
6,351386,343.1503906,634,545,1179,
6,360862,352.4042969,552,445,997,
6,370338,361.6582031,508,429,937,
6,379818,370.9160156,546,452,998,
6,389284,380.1601563,750,252,1002,
6,398752,389.40625,498,372,870,
6,408224,398.65625,700,590,1290,
6,417708,407.9179688,676,591,1267,
6,427184,417.171875,525,424,949,
6,436670,426.4355469,905,473,1378,
6,446144,435.6875,883,512,1395,
6,455630,444.9511719,404,307,711,
6,465116,454.2148438,755,660,1415,
6,474604,463.4804688,724,556,1280,
6,484082,472.7363281,913,784,1697,
6,493566,481.9980469,977,839,1816,
6,503026,491.2363281,1390,966,2356,
6,512498,500.4863281,455,357,812,
6,521978,509.7441406,1688,1559,3247,
6,531462,519.0058594,573,412,985,
6,540942,528.2636719,1013,831,1844,
6,550424,537.5234375,625,437,1062,
6,559892,546.7695313,1098,912,2010,
6,569364,556.0195313,770,643,1413,
6,578862,565.2949219,813,684,1497,
6,588330,574.5410156,1040,923,1963,
6,597808,583.796875,813,694,1507,
6,607280,593.046875,842,725,1567,
6,616766,602.3105469,957,842,1799,
6,626236,611.5585938,1038,919,1957,
6,635724,620.8242188,1110,998,2108,
6,645210,630.0878906,1073,964,2037,
6,654678,639.3339844,702,595,1297,
6,664146,648.5800781,2317,2203,4520,
6,673620,657.8320313,1889,1776,3665,
6,683100,667.0898438,1783,1662,3445,
6,692560,676.328125,1397,1278,2675,
6,702032,685.578125,1837,1696,3533,
6,711504,694.828125,1567,1446,3013,
6,720988,704.0898438,1542,1376,2918,
6,730474,713.3535156,1652,1495,3147,
6,739960,722.6171875,1571,1430,3001,
6,749432,731.8671875,1277,1129,2406,
6,758920,741.1328125,1696,1561,3257,
6,768406,750.3964844,1789,1641,3430,
6,777890,759.6582031,1615,1475,3090,
6,787360,768.90625,1417,1290,2707,
6,796838,778.1621094,1950,1797,3747,
6,806310,787.4121094,1305,1169,2474,
6,815776,796.65625,2185,1599,3784,
6,825262,805.9199219,1828,1258,3086,
6,834740,815.1757813,1789,1336,3125,
6,844210,824.4238281,2103,1934,4037,
6,853702,833.6933594,2057,1835,3892,
6,863162,842.9316406,1943,1773,3716,
6,872624,852.171875,1806,1629,3435,
6,882114,861.4394531,1697,1507,3204,
6,891582,870.6855469,1688,1519,3207,
6,901062,879.9433594,1816,1612,3428,
6,910546,889.2050781,1707,1525,3232,
6,920030,898.4667969,1634,1460,3094,
6,929512,907.7265625,1721,1564,3285,
6,938988,916.9804688,1664,1506,3170,
6,948482,926.2519531,1666,1511,3177,
6,957966,935.5136719,1780,1601,3381,
6,967446,944.7714844,1805,1631,3436,
6,976926,954.0292969,1663,1508,3171,
6,986392,963.2734375,1460,1294,2754,
6,995876,972.5351563,2007,1850,3857,
6,1005350,981.7871094,2881,2663,5544,
6,1014816,991.03125,2558,2299,4857,
6,1024302,1000.294922,2353,2139,4492,
6,1033780,1009.550781,2467,2246,4713,
6,1043256,1018.804688,2416,2233,4649,
6,1052722,1028.048828,2516,2324,4840,
6,1062186,1037.291016,2566,2383,4949,
6,1071648,1046.53125,2471,2273,4744,
6,1081114,1055.775391,2409,2223,4632,
6,1090584,1065.023438,2463,2280,4743,
6,1100048,1074.265625,2549,2320,4869,
6,1109532,1083.527344,2508,2295,4803,
6,1119002,1092.775391,2674,2395,5069,
6,1128472,1102.023438,2650,2452,5102,
6,1137950,1111.279297,2528,2340,4868,
6,1147430,1120.537109,2588,2387,4975,
6,1156890,1129.775391,2600,2343,4943,
6,1166368,1139.03125,2520,2310,4830,
6,1175864,1148.304688,2605,2350,4955,
6,1185334,1157.552734,2674,2455,5129,
6,1194804,1166.800781,2272,1995,4267,
6,1204286,1176.060547,2251,2015,4266,
6,1213764,1185.316406,2431,2203,4634,
6,1223246,1194.576172,2254,2046,4300,
6,1232722,1203.830078,2316,2108,4424,
6,1242206,1213.091797,2251,2027,4278,
6,1251682,1222.345703,2258,2030,4288,
6,1261150,1231.591797,2345,2086,4431,
6,1270612,1240.832031,2290,2076,4366,
6,1280104,1250.101563,2386,2173,4559,
6,1289574,1259.349609,2406,2143,4549,
6,1299058,1268.611328,2422,2106,4528,
6,1308516,1277.847656,2246,1938,4184,
6,1318020,1287.128906,2384,2115,4499,
6,1327496,1296.382813,2369,2139,4508,
6,1336964,1305.628906,2169,1916,4085,
6,1346442,1314.884766,4331,4041,8372,
6,1355926,1324.146484,3367,3088,6455,
6,1365394,1333.392578,3150,2914,6064,
6,1374864,1342.640625,3326,3037,6363,BAn20m10 (iteration 1)
6,10276,10.03515625,115,69,184,
6,19758,19.29492188,115,72,187,
6,29230,28.54492188,118,84,202,
6,38714,37.80664063,99,57,156,
6,48200,47.0703125,163,109,272,
6,57672,56.3203125,107,71,178,
6,67138,65.56445313,108,69,177,
6,76600,74.8046875,101,61,162,
6,86064,84.046875,145,90,235,
6,95528,93.2890625,99,53,152,
6,104998,102.5371094,252,111,363,
6,114470,111.7871094,212,100,312,
6,123944,121.0390625,203,98,301,
6,133422,130.2949219,188,75,263,
6,142906,139.5566406,299,80,379,
6,152396,148.8242188,338,65,403,
6,161864,158.0703125,588,146,734,
6,171340,167.3242188,322,108,430,
6,180804,176.5664063,171,69,240,
6,190272,185.8125,5468,5246,10714,
6,199742,195.0605469,400,187,587,
6,209230,204.3261719,690,435,1125,
6,218700,213.5742188,521,265,786,
6,228176,222.828125,1061,811,1872,
6,237652,232.0820313,1170,986,2156,
6,247144,241.3515625,140,69,209,
6,256624,250.609375,192,99,291,
6,266100,259.8632813,1033,805,1838,
6,275586,269.1269531,261,124,385,
6,285058,278.3769531,168,85,253,
6,294538,287.6347656,148,67,215,
6,303996,296.8710938,1356,1129,2485,
6,313484,306.1367188,731,643,1374,
6,322974,315.4042969,839,729,1568,
6,332452,324.6601563,607,505,1112,
6,341918,333.9042969,607,482,1089,
6,351398,343.1621094,621,458,1079,
6,360876,352.4179688,534,418,952,
6,370358,361.6777344,607,493,1100,
6,379834,370.9316406,554,405,959,
6,389318,380.1933594,550,404,954,
6,398796,389.4492188,544,399,943,
6,408280,398.7109375,773,464,1237,
6,417756,407.9648438,862,706,1568,
6,427232,417.21875,595,456,1051,
6,436706,426.4707031,840,429,1269,
6,446170,435.7128906,605,434,1039,
6,455638,444.9589844,719,601,1320,
6,465104,454.203125,690,588,1278,
6,474574,463.4511719,788,663,1451,
6,484060,472.7148438,1040,898,1938,
6,493536,481.96875,986,864,1850,
6,503008,491.21875,1605,1229,2834,
6,512494,500.4824219,934,440,1374,
6,521986,509.7519531,1349,840,2189,
6,531470,519.0136719,726,594,1320,
6,540954,528.2753906,671,560,1231,
6,550426,537.5253906,1126,980,2106,
6,559904,546.78125,840,695,1535,
6,569372,556.0273438,692,559,1251,
6,578856,565.2890625,795,680,1475,
6,588332,574.5429688,662,554,1216,
6,597818,583.8066406,1020,879,1899,
6,607280,593.046875,986,866,1852,
6,616756,602.3007813,1043,921,1964,
6,626220,611.5429688,651,510,1161,
6,635708,620.8085938,1442,1336,2778,
6,645178,630.0566406,1391,1242,2633,
6,654654,639.3105469,776,644,1420,
6,664152,648.5859375,2417,2299,4716,
6,673636,657.8476563,2245,2131,4376,
6,683130,667.1191406,1410,1273,2683,
6,692606,676.3730469,1950,1804,3754,
6,702096,685.640625,2392,2225,4617,
6,711568,694.890625,1902,1774,3676,
6,721050,704.1503906,1949,1807,3756,
6,730520,713.3984375,1795,1521,3316,
6,739990,722.6464844,1912,1373,3285,
6,749466,731.9003906,1843,1301,3144,
6,758938,741.1503906,1582,1330,2912,
6,768420,750.4101563,1680,1534,3214,
6,777892,759.6601563,1679,1535,3214,
6,787372,768.9179688,1461,1300,2761,
6,796848,778.171875,1956,1810,3766,
6,806330,787.4316406,1787,1642,3429,
6,815806,796.6855469,1848,1326,3174,
6,825288,805.9453125,1791,1615,3406,
6,834766,815.2011719,1933,1750,3683,
6,844244,824.4570313,1742,1561,3303,
6,853726,833.7167969,1788,1628,3416,
6,863208,842.9765625,1838,1661,3499,
6,872682,852.2285156,1497,1323,2820,
6,882160,861.484375,2174,1964,4138,
6,891632,870.734375,1950,1732,3682,
6,901118,879.9980469,1694,1545,3239,
6,910592,889.25,1913,1687,3600,
6,920070,898.5058594,1851,1684,3535,
6,929542,907.7558594,1886,1710,3596,
6,939014,917.0058594,1826,1644,3470,
6,948502,926.2714844,1918,1696,3614,
6,957972,935.5195313,1989,1495,3484,
6,967458,944.7832031,1936,1772,3708,
6,976932,954.0351563,2023,929,2952,
6,986412,963.2929688,1874,1699,3573,
6,995888,972.546875,1981,1784,3765,
6,1005366,981.8027344,3171,2950,6121,
6,1014846,991.0605469,2554,2358,4912,
6,1024322,1000.314453,2500,2266,4766,
6,1033802,1009.572266,2810,2615,5425,
6,1043272,1018.820313,2558,2351,4909,
6,1052756,1028.082031,2595,2417,5012,
6,1062230,1037.333984,2695,2491,5186,
6,1071702,1046.583984,2718,2517,5235,
6,1081176,1055.835938,2646,2466,5112,
6,1090658,1065.095703,2753,2562,5315,
6,1100128,1074.34375,2124,1883,4007,
6,1109612,1083.605469,2632,2427,5059,
6,1119082,1092.853516,2846,2605,5451,
6,1128550,1102.099609,2598,2417,5015,
6,1138026,1111.353516,2611,2408,5019,
6,1147504,1120.609375,2727,2522,5249,
6,1156980,1129.863281,2682,2450,5132,
6,1166458,1139.119141,2653,2444,5097,
6,1175940,1148.378906,2612,2418,5030,
6,1185422,1157.638672,2728,2546,5274,
6,1194904,1166.898438,2617,2373,4990,
6,1204378,1176.150391,2674,2434,5108,
6,1213868,1185.417969,2798,2543,5341,
6,1223338,1194.666016,2776,2542,5318,
6,1232820,1203.925781,2590,2369,4959,
6,1242306,1213.189453,2776,2559,5335,
6,1251786,1222.447266,2668,2454,5122,
6,1261262,1231.701172,2786,2552,5338,
6,1270746,1240.962891,2869,2582,5451,
6,1280210,1250.205078,3430,3165,6595,
6,1289690,1259.462891,2240,1896,4136,
6,1299162,1268.712891,2441,2186,4627,
6,1308650,1277.978516,2358,2112,4470,
6,1318112,1287.21875,2919,2644,5563,
6,1327592,1296.476563,2315,2083,4398,
6,1337072,1305.734375,2431,2185,4616,
6,1346550,1314.990234,4310,4062,8372,
6,1356018,1324.236328,3247,2907,6154,
6,1365478,1333.474609,3223,2981,6204,
6,1374962,1342.736328,3700,3423,7123,BAn20m10 (iteration 2)
6,10290,10.04882813,122,77,199,
6,19778,19.31445313,130,82,212,
6,29256,28.5703125,116,75,191,
6,38734,37.82617188,116,76,192,
6,48222,47.09179688,99,56,155,
6,57708,56.35546875,153,102,255,
6,67176,65.6015625,136,87,223,
6,76652,74.85546875,131,80,211,
6,86138,84.11914063,123,67,190,
6,95616,93.375,203,148,351,
6,105096,102.6328125,307,128,435,
6,114568,111.8828125,302,154,456,
6,124056,121.1484375,287,141,428,
6,133530,130.4003906,259,82,341,
6,143006,139.6542969,327,150,477,
6,152480,148.90625,203,64,267,
6,161958,158.1621094,297,115,412,
6,171422,167.4042969,240,82,322,
6,180896,176.65625,232,114,346,
6,190374,185.9121094,5183,4931,10114,
6,199840,195.15625,338,148,486,
6,209322,204.4160156,495,319,814,
6,218808,213.6796875,702,529,1231,
6,228284,222.9335938,1740,1514,3254,
6,237768,232.1953125,399,166,565,
6,247244,241.4492188,376,117,493,
6,256734,250.7167969,267,105,372,
6,266214,259.9746094,394,160,554,
6,275688,269.2265625,281,66,347,
6,285172,278.4882813,316,76,392,
6,294658,287.7519531,276,70,346,
6,304140,297.0117188,1308,1043,2351,
6,313618,306.2675781,939,778,1717,
6,323096,315.5234375,757,458,1215,
6,332578,324.7832031,656,251,907,
6,342062,334.0449219,576,296,872,
6,351534,343.2949219,607,275,882,
6,361012,352.5507813,611,302,913,
6,370480,361.796875,610,262,872,
6,379962,371.0566406,510,185,695,
6,389436,380.3085938,451,325,776,
6,398916,389.5664063,720,572,1292,
6,408394,398.8222656,495,284,779,
6,417876,408.0820313,972,515,1487,
6,427344,417.328125,865,482,1347,
6,436834,426.5957031,796,513,1309,
6,446306,435.8457031,697,426,1123,
6,455772,445.0898438,610,411,1021,
6,465236,454.3320313,658,556,1214,
6,474704,463.578125,597,479,1076,
6,484176,472.828125,766,513,1279,
6,493648,482.078125,702,481,1183,
6,503142,491.3496094,1613,1096,2709,
6,512626,500.6113281,823,455,1278,
6,522100,509.8632813,1146,604,1750,
6,531568,519.109375,366,263,629,
6,541050,528.3691406,888,722,1610,
6,550526,537.6230469,922,753,1675,
6,559986,546.8613281,925,743,1668,
6,569458,556.1113281,662,480,1142,
6,578922,565.3535156,1500,793,2293,
6,588390,574.5996094,946,833,1779,
6,597880,583.8671875,1459,1035,2494,
6,607336,593.1015625,1345,964,2309,
6,616814,602.3574219,1326,812,2138,
6,626298,611.6191406,495,381,876,
6,635766,620.8652344,1641,1527,3168,
6,645242,630.1191406,520,414,934,
6,654720,639.375,943,844,1787,
6,664194,648.6269531,2075,1956,4031,
6,673674,657.8847656,2109,2005,4114,
6,683164,667.1523438,1668,1558,3226,
6,692632,676.3984375,1738,1632,3370,
6,702116,685.6601563,1784,1632,3416,
6,711602,694.9238281,1684,1569,3253,
6,721080,704.1796875,1484,1324,2808,
6,730554,713.4316406,1876,1737,3613,
6,740022,722.6777344,1674,1521,3195,
6,749514,731.9472656,1879,1746,3625,
6,758996,741.2070313,1434,1286,2720,
6,768474,750.4628906,2045,1912,3957,
6,777952,759.71875,1825,1706,3531,
6,787440,768.984375,1683,1543,3226,
6,796914,778.2363281,2030,1904,3934,
6,806392,787.4921875,1672,1532,3204,
6,815880,796.7578125,2038,1844,3882,
6,825356,806.0117188,1966,1792,3758,
6,834814,815.2480469,2175,1997,4172,
6,844290,824.5019531,1560,1383,2943,
6,853762,833.7519531,2266,2001,4267,
6,863232,843,1930,1201,3131,
6,872704,852.25,1958,1093,3051,
6,882184,861.5078125,2035,1522,3557,
6,891654,870.7558594,2026,1867,3893,
6,901136,880.015625,1853,1665,3518,
6,910602,889.2597656,1859,1656,3515,
6,920084,898.5195313,1773,1583,3356,
6,929568,907.78125,1789,1637,3426,
6,939062,917.0527344,1878,1699,3577,
6,948546,926.3144531,1745,1569,3314,
6,958028,935.5742188,1795,1622,3417,
6,967512,944.8359375,1912,1720,3632,
6,976994,954.0957031,1892,1706,3598,
6,986474,963.3535156,1993,1787,3780,
6,995932,972.5898438,1830,1592,3422,
6,1005398,981.8339844,3072,2836,5908,
6,1014878,991.0917969,2632,2416,5048,
6,1024362,1000.353516,2608,2387,4995,
6,1033842,1009.611328,2672,2461,5133,
6,1043318,1018.865234,2562,2368,4930,
6,1052804,1028.128906,3075,2881,5956,
6,1062272,1037.375,2652,2403,5055,
6,1071740,1046.621094,2713,2442,5155,
6,1081224,1055.882813,2518,2301,4819,
6,1090692,1065.128906,2785,2549,5334,
6,1100174,1074.388672,3078,2817,5895,
6,1109654,1083.646484,2611,2332,4943,
6,1119130,1092.900391,2655,2406,5061,
6,1128606,1102.154297,3069,2821,5890,
6,1138088,1111.414063,2892,2680,5572,
6,1147566,1120.669922,2514,2327,4841,
6,1157038,1129.919922,2766,2559,5325,
6,1166528,1139.1875,2665,2462,5127,
6,1175988,1148.425781,2662,2457,5119,
6,1185458,1157.673828,2641,2438,5079,
6,1194932,1166.925781,2812,2558,5370,
6,1204402,1176.173828,2689,2425,5114,
6,1213874,1185.423828,2722,2477,5199,
6,1223366,1194.693359,2751,2540,5291,
6,1232848,1203.953125,2886,2678,5564,
6,1242320,1213.203125,2750,2533,5283,
6,1251790,1222.451172,3745,3513,7258,
6,1261250,1231.689453,3101,2847,5948,
6,1270732,1240.949219,2812,2532,5344,
6,1280214,1250.208984,2787,2559,5346,
6,1289700,1259.472656,2341,2033,4374,
6,1299170,1268.720703,2299,2036,4335,
6,1308650,1277.978516,2743,2503,5246,
6,1318126,1287.232422,2300,2043,4343,
6,1327618,1296.501953,2476,2233,4709,
6,1337102,1305.763672,2378,2128,4506,
6,1346584,1315.023438,4714,4479,9193,
6,1356070,1324.287109,3510,3227,6737,
6,1365538,1333.533203,3214,2967,6181,
6,1375030,1342.802734,3376,3114,6490,BAn20m10 (iteration 3)
6,10276,10.03515625,119,76,195,
6,19744,19.28125,145,87,232,
6,29214,28.52929688,123,73,196,
6,38698,37.79101563,118,72,190,
6,48188,47.05859375,116,64,180,
6,57670,56.31835938,107,67,174,
6,67128,65.5546875,103,58,161,
6,76600,74.8046875,135,89,224,
6,86074,84.05664063,157,88,245,
6,95546,93.30664063,117,69,186,
6,105030,102.5683594,146,65,211,
6,114494,111.8105469,163,92,255,
6,123964,121.0585938,171,89,260,
6,133444,130.3164063,194,101,295,
6,142924,139.5742188,168,65,233,
6,152400,148.828125,174,70,244,
6,161864,158.0703125,163,87,250,
6,171338,167.3222656,160,83,243,
6,180828,176.5898438,118,70,188,
6,190316,185.8554688,213,116,329,
6,199776,195.09375,233,101,334,
6,209256,204.3515625,207,111,318,
6,218720,213.59375,4790,4673,9463,
6,228180,222.8320313,385,305,690,
6,237638,232.0683594,468,411,879,
6,247112,241.3203125,782,666,1448,
6,256586,250.5722656,528,459,987,
6,266062,259.8261719,364,92,456,
6,275548,269.0898438,474,188,662,
6,285026,278.3457031,1387,1087,2474,
6,294516,287.6132813,378,71,449,
6,303990,296.8652344,1640,1294,2934,
6,313464,306.1171875,1019,434,1453,
6,322942,315.3730469,938,366,1304,
6,332422,324.6308594,722,414,1136,
6,341910,333.8964844,922,580,1502,
6,351392,343.15625,785,182,967,
6,360880,352.421875,561,222,783,
6,370356,361.6757813,837,344,1181,
6,379812,370.9101563,879,200,1079,
6,389270,380.1464844,1388,252,1640,
6,398754,389.4082031,1248,127,1375,
6,408230,398.6621094,849,282,1131,
6,417712,407.921875,944,351,1295,
6,427202,417.1894531,905,260,1165,
6,436682,426.4472656,372,254,626,
6,446154,435.6972656,804,684,1488,
6,455624,444.9453125,655,544,1199,
6,465110,454.2089844,709,609,1318,
6,474590,463.4667969,742,628,1370,
6,484058,472.7128906,975,868,1843,
6,493518,481.9511719,1147,1030,2177,
6,502996,491.2070313,1446,1286,2732,
6,512496,500.484375,1306,392,1698,
6,521970,509.7363281,445,190,635,
6,531442,518.9863281,783,406,1189,
6,540916,528.2382813,1828,840,2668,
6,550396,537.4960938,1328,853,2181,
6,559864,546.7421875,1160,983,2143,
6,569338,555.9941406,1193,848,2041,
6,578804,565.2382813,1248,779,2027,
6,588276,574.4882813,1280,586,1866,
6,597760,583.75,712,531,1243,
6,607236,593.0039063,953,831,1784,
6,616720,602.265625,936,819,1755,
6,626200,611.5234375,2191,2068,4259,
6,635678,620.7792969,712,602,1314,
6,645168,630.046875,588,479,1067,
6,654640,639.296875,1109,1002,2111,
6,664120,648.5546875,2143,2003,4146,
6,673586,657.7988281,2115,2002,4117,
6,683052,667.0429688,1740,1530,3270,
6,692530,676.2988281,1874,1570,3444,
6,702004,685.5507813,1756,1539,3295,
6,711482,694.8066406,1673,1553,3226,
6,720964,704.0664063,1847,1698,3545,
6,730434,713.3144531,1461,1328,2789,
6,739912,722.5703125,1701,1554,3255,
6,749384,731.8203125,1826,1687,3513,
6,758862,741.0761719,1944,1808,3752,
6,768334,750.3261719,1448,1323,2771,
6,777824,759.59375,2155,2028,4183,
6,787300,768.8476563,1846,1712,3558,
6,796776,778.1015625,1729,1604,3333,
6,806254,787.3574219,1875,1746,3621,
6,815728,796.609375,1728,1544,3272,
6,825194,805.8535156,1762,1578,3340,
6,834654,815.0917969,1953,1806,3759,
6,844134,824.3496094,1537,1337,2874,
6,853622,833.6152344,2034,1874,3908,
6,863102,842.8730469,1829,1667,3496,
6,872588,852.1367188,1816,1649,3465,
6,882066,861.3925781,1570,1422,2992,
6,891540,870.6445313,2316,2170,4486,
6,901022,879.9042969,1766,1623,3389,
6,910506,889.1660156,1863,1679,3542,
6,919988,898.4257813,1840,1659,3499,
6,929448,907.6640625,2223,2072,4295,
6,938922,916.9160156,1712,1544,3256,
6,948398,926.1699219,2086,1936,4022,
6,957876,935.4257813,1589,1428,3017,
6,967356,944.6835938,1925,1762,3687,
6,976838,953.9433594,2239,2067,4306,
6,986318,963.2011719,1889,1727,3616,
6,995786,972.4472656,1951,1773,3724,
6,1005272,981.7109375,3101,2911,6012,
6,1014744,990.9609375,2681,2495,5176,
6,1024216,1000.210938,2584,2383,4967,
6,1033694,1009.466797,2613,2411,5024,
6,1043180,1018.730469,2476,2289,4765,
6,1052656,1027.984375,2714,2527,5241,
6,1062112,1037.21875,2538,2365,4903,
6,1071588,1046.472656,2668,2486,5154,
6,1081072,1055.734375,2485,2292,4777,
6,1090552,1064.992188,2739,2561,5300,
6,1100020,1074.238281,2665,2367,5032,
6,1109494,1083.490234,2720,2506,5226,
6,1118972,1092.746094,2549,2319,4868,
6,1128444,1101.996094,2697,2498,5195,
6,1137918,1111.248047,2673,2488,5161,
6,1147392,1120.5,2731,2507,5238,
6,1156874,1129.759766,2694,2491,5185,
6,1166360,1139.023438,2906,2707,5613,
6,1175846,1148.287109,2647,2453,5100,
6,1185336,1157.554688,2657,2455,5112,
6,1194802,1166.798828,3149,2895,6044,
6,1204276,1176.050781,3028,2375,5403,
6,1213762,1185.314453,2883,2413,5296,
6,1223252,1194.582031,2820,2590,5410,
6,1232722,1203.830078,3276,3021,6297,
6,1242200,1213.085938,3110,2883,5993,
6,1251680,1222.34375,2842,2613,5455,
6,1261160,1231.601563,2763,2518,5281,
6,1270634,1240.853516,2740,2502,5242,
6,1280106,1250.103516,3142,2882,6024,
6,1289574,1259.349609,2514,2208,4722,
6,1299044,1268.597656,2867,2574,5441,
6,1308526,1277.857422,2445,2188,4633,
6,1317996,1287.105469,2647,2400,5047,
6,1327476,1296.363281,3015,2494,5509,
6,1336948,1305.613281,3857,3188,7045,
6,1346426,1314.869141,3052,2787,5839,
6,1355898,1324.119141,3486,2160,5646,
6,1365362,1333.361328,3240,2975,6215,
6,1374836,1342.613281,3481,2269,5750,BAn20m10 (iteration 4)
6,10282,10.04101563,91,56,147,
6,19758,19.29492188,98,62,160,
6,29250,28.56445313,112,73,185,
6,38724,37.81640625,119,77,196,
6,48216,47.0859375,146,101,247,
6,57696,56.34375,103,61,164,
6,67170,65.59570313,93,59,152,
6,76654,74.85742188,135,95,230,
6,86140,84.12109375,118,71,189,
6,95604,93.36328125,100,61,161,
6,105082,102.6191406,123,70,193,
6,114540,111.8554688,131,71,202,
6,124012,121.1054688,149,91,240,
6,133486,130.3574219,195,118,313,
6,142958,139.6074219,231,114,345,
6,152426,148.8535156,150,55,205,
6,161908,158.1132813,202,106,308,
6,171394,167.3769531,186,82,268,
6,180854,176.6152344,191,71,262,
6,190338,185.8769531,4926,4793,9719,
6,199822,195.1386719,174,68,242,
6,209304,204.3984375,808,691,1499,
6,218776,213.6484375,1115,983,2098,
6,228262,222.9121094,157,61,218,
6,237722,232.1503906,237,141,378,
6,247184,241.390625,240,106,346,
6,256666,250.6503906,203,100,303,
6,266136,259.8984375,1065,876,1941,
6,275608,269.1484375,280,143,423,
6,285090,278.4082031,361,139,500,
6,294566,287.6621094,260,91,351,
6,304052,296.9257813,892,728,1620,
6,313520,306.171875,979,784,1763,
6,322998,315.4277344,602,388,990,
6,332472,324.6796875,489,309,798,
6,341952,333.9375,732,529,1261,
6,351430,343.1933594,476,262,738,
6,360912,352.453125,648,445,1093,
6,370402,361.7207031,619,288,907,
6,379870,370.9667969,759,487,1246,
6,389346,380.2207031,652,274,926,
6,398820,389.4726563,434,188,622,
6,408316,398.7460938,537,288,825,
6,417800,408.0078125,762,466,1228,
6,427290,417.2753906,921,492,1413,
6,436770,426.5332031,521,416,937,
6,446252,435.7929688,684,574,1258,
6,455730,445.0488281,737,644,1381,
6,465226,454.3222656,687,579,1266,
6,474700,463.5742188,781,679,1460,
6,484166,472.8183594,976,870,1846,
6,493650,482.0800781,981,863,1844,
6,503132,491.3398438,1706,734,2440,
6,512612,500.5976563,1170,434,1604,
6,522092,509.8554688,640,502,1142,
6,531576,519.1171875,1265,669,1934,
6,541050,528.3691406,1028,533,1561,
6,550510,537.6074219,1354,408,1762,
6,559970,546.8457031,1118,562,1680,
6,569448,556.1015625,767,620,1387,
6,578950,565.3808594,1053,898,1951,
6,588430,574.6386719,728,587,1315,
6,597894,583.8808594,927,762,1689,
6,607378,593.1425781,1010,885,1895,
6,616858,602.4003906,1119,1005,2124,
6,626344,611.6640625,898,762,1660,
6,635828,620.9257813,1996,1884,3880,
6,645304,630.1796875,492,384,876,
6,654778,639.4316406,1053,957,2010,
6,664250,648.6816406,1963,1856,3819,
6,673716,657.9257813,1982,1861,3843,
6,683184,667.171875,1891,1763,3654,
6,692660,676.4257813,2001,1879,3880,
6,702136,685.6796875,1572,1461,3033,
6,711598,694.9199219,1681,1560,3241,
6,721054,704.1542969,1916,1773,3689,
6,730534,713.4121094,1779,1631,3410,
6,740014,722.6699219,1514,1373,2887,
6,749486,731.9199219,1973,1841,3814,
6,758968,741.1796875,1816,1706,3522,
6,768450,750.4394531,1697,1568,3265,
6,777922,759.6894531,1662,1530,3192,
6,787418,768.9628906,1852,1723,3575,
6,796912,778.234375,1804,1660,3464,
6,806390,787.4902344,1488,1341,2829,
6,815862,796.7402344,1778,1611,3389,
6,825332,805.9882813,1944,1768,3712,
6,834820,815.2539063,1744,1567,3311,
6,844302,824.5136719,1942,1783,3725,
6,853778,833.7675781,1726,1545,3271,
6,863238,843.0058594,1922,1627,3549,
6,872718,852.2636719,1950,1681,3631,
6,882188,861.5117188,1858,1698,3556,
6,891666,870.7675781,1786,1643,3429,
6,901150,880.0292969,1973,1724,3697,
6,910638,889.2949219,1735,1553,3288,
6,920122,898.5566406,1425,1268,2693,
6,929588,907.8007813,2213,2051,4264,
6,939064,917.0546875,1768,1616,3384,
6,948530,926.2988281,1611,1458,3069,
6,958008,935.5546875,1915,1755,3670,
6,967488,944.8125,2042,1886,3928,
6,976972,954.0742188,1945,1773,3718,
6,986446,963.3261719,1721,1506,3227,
6,995914,972.5722656,2155,1992,4147,
6,1005382,981.8183594,3130,2945,6075,
6,1014846,991.0605469,2507,2305,4812,
6,1024316,1000.308594,2712,2492,5204,
6,1033798,1009.568359,2647,2477,5124,
6,1043270,1018.818359,2636,2459,5095,
6,1052738,1028.064453,2615,2444,5059,
6,1062224,1037.328125,2726,2519,5245,
6,1071706,1046.587891,2683,2489,5172,
6,1081194,1055.853516,2603,2423,5026,
6,1090672,1065.109375,2611,2430,5041,
6,1100148,1074.363281,2647,2436,5083,
6,1109614,1083.607422,2662,2434,5096,
6,1119090,1092.861328,2595,2373,4968,
6,1128564,1102.113281,2649,2442,5091,
6,1138050,1111.376953,2763,2571,5334,
6,1147526,1120.630859,2661,2424,5085,
6,1157014,1129.896484,2787,2584,5371,
6,1166492,1139.152344,2669,2440,5109,
6,1175982,1148.419922,3123,2920,6043,
6,1185452,1157.667969,2619,2424,5043,
6,1194928,1166.921875,3016,2758,5774,
6,1204402,1176.173828,3129,2896,6025,
6,1213888,1185.4375,2759,2412,5171,
6,1223368,1194.695313,2667,2458,5125,
6,1232842,1203.947266,3375,3105,6480,
6,1242316,1213.199219,3001,2747,5748,
6,1251794,1222.455078,3234,2960,6194,
6,1261272,1231.710938,3249,2998,6247,
6,1270738,1240.955078,3194,2944,6138,
6,1280228,1250.222656,2888,2615,5503,
6,1289708,1259.480469,2351,1769,4120,
6,1299196,1268.746094,2619,1976,4595,
6,1308676,1278.003906,2459,820,3279,
6,1318160,1287.265625,2334,2118,4452,
6,1327640,1296.523438,2970,2599,5569,
6,1337128,1305.789063,2499,2278,4777,
6,1346594,1315.033203,3968,3728,7696,
6,1356080,1324.296875,3495,3260,6755,
6,1365558,1333.552734,3383,3120,6503,
6,1375058,1342.830078,3180,2939,6119,BAn20m10 (iteration 5)
6,10282,10.04101563,101,67,168,
6,19754,19.29101563,106,62,168,
6,29244,28.55859375,117,82,199,
6,38712,37.8046875,97,61,158,
6,48198,47.06835938,106,71,177,
6,57688,56.3359375,117,81,198,
6,67164,65.58984375,93,55,148,
6,76640,74.84375,166,112,278,
6,86114,84.09570313,110,67,177,
6,95588,93.34765625,118,65,183,
6,105052,102.5898438,121,82,203,
6,114526,111.8417969,101,56,157,
6,124004,121.0976563,110,65,175,
6,133488,130.359375,107,63,170,
6,142960,139.609375,134,90,224,
6,152446,148.8730469,241,94,335,
6,161938,158.1425781,264,110,374,
6,171418,167.4003906,150,71,221,
6,180912,176.671875,184,99,283,
6,190390,185.9277344,184,78,262,
6,199862,195.1777344,184,68,252,
6,209334,204.4277344,201,116,317,
6,218804,213.6757813,141,78,219,
6,228286,222.9355469,1694,1626,3320,
6,237770,232.1972656,1216,1159,2375,
6,247244,241.4492188,155,86,241,
6,256724,250.7070313,150,77,227,
6,266202,259.9628906,235,158,393,
6,275686,269.2246094,179,88,267,
6,285148,278.4648438,3786,3599,7385,
6,294624,287.71875,269,134,403,
6,304096,296.96875,625,494,1119,
6,313594,306.2441406,3279,3208,6487,
6,323064,315.4921875,521,449,970,
6,332548,324.7539063,745,659,1404,
6,342030,334.0136719,763,677,1440,
6,351508,343.2695313,880,807,1687,
6,360982,352.5214844,456,372,828,
6,370456,361.7734375,5150,5054,10204,
6,379934,371.0292969,904,833,1737,
6,389412,380.2851563,566,465,1031,
6,398892,389.5429688,580,503,1083,
6,408370,398.7988281,576,454,1030,
6,417840,408.046875,712,584,1296,
6,427306,417.2910156,674,492,1166,
6,436778,426.5410156,1119,329,1448,
6,446248,435.7890625,573,255,828,
6,455722,445.0410156,873,450,1323,
6,465194,454.2910156,938,534,1472,
6,474684,463.5585938,940,179,1119,
6,484166,472.8183594,1191,144,1335,
6,493642,482.0722656,847,516,1363,
6,503112,491.3203125,448,347,795,
6,512600,500.5859375,858,732,1590,
6,522078,509.8417969,1306,445,1751,
6,531558,519.0996094,776,227,1003,
6,541042,528.3613281,879,604,1483,
6,550518,537.6152344,967,671,1638,
6,559986,546.8613281,1536,429,1965,
6,569458,556.1113281,1858,350,2208,
6,578932,565.3632813,984,357,1341,
6,588398,574.6074219,1320,707,2027,
6,597892,583.8789063,664,215,879,
6,607380,593.1445313,586,400,986,
6,616866,602.4082031,810,466,1276,
6,626350,611.6699219,3379,850,4229,
6,635830,620.9277344,1860,195,2055,
6,645312,630.1875,1826,825,2651,
6,654782,639.4355469,2619,909,3528,
6,664266,648.6972656,1759,224,1983,
6,673754,657.9628906,1396,689,2085,
6,683232,667.21875,1534,411,1945,
6,692708,676.4726563,1552,1211,2763,
6,702202,685.7441406,1212,1043,2255,
6,711684,695.0039063,1654,1464,3118,
6,721152,704.25,1571,1222,2793,
6,730638,713.5136719,1995,1790,3785,
6,740112,722.765625,1535,1407,2942,
6,749586,732.0175781,1509,1323,2832,
6,759064,741.2734375,1438,1311,2749,
6,768548,750.5351563,1254,1128,2382,
6,778030,759.7949219,1850,1699,3549,
6,787504,769.046875,1425,1306,2731,
6,796982,778.3027344,1482,1332,2814,
6,806458,787.5566406,1531,973,2504,
6,815938,796.8144531,1628,1440,3068,
6,825416,806.0703125,1528,1399,2927,
6,834892,815.3242188,1594,1457,3051,
6,844378,824.5878906,1755,1606,3361,
6,853862,833.8496094,1524,1380,2904,
6,863350,843.1152344,1691,1553,3244,
6,872812,852.3554688,1765,1618,3383,
6,882290,861.6113281,4015,940,4955,
6,891766,870.8652344,4107,1103,5210,
6,901226,880.1035156,1904,1562,3466,
6,910696,889.3515625,1661,1092,2753,
6,920176,898.609375,2374,2153,4527,
6,929646,907.8574219,2147,1896,4043,
6,939126,917.1152344,2070,1882,3952,
6,948608,926.375,1891,1267,3158,
6,958088,935.6328125,2120,1830,3950,
6,967564,944.8867188,1809,1633,3442,
6,977038,954.1386719,2088,1897,3985,
6,986514,963.3925781,2061,1883,3944,
6,995980,972.6367188,1979,1819,3798,
6,1005450,981.8847656,3164,2932,6096,
6,1014916,991.1289063,2344,2174,4518,
6,1024390,1000.380859,2563,1157,3720,
6,1033868,1009.636719,2549,2089,4638,
6,1043338,1018.884766,2672,1288,3960,
6,1052822,1028.146484,4792,1671,6463,
6,1062290,1037.392578,2677,1232,3909,
6,1071754,1046.634766,3246,1902,5148,
6,1081234,1055.892578,2690,2454,5144,
6,1090714,1065.150391,2604,2392,4996,
6,1100184,1074.398438,2513,2301,4814,
6,1109648,1083.640625,2854,2170,5024,
6,1119104,1092.875,2683,1855,4538,
6,1128580,1102.128906,3137,2913,6050,
6,1138056,1111.382813,2952,1382,4334,
6,1147536,1120.640625,2970,1910,4880,
6,1157024,1129.90625,2653,2264,4917,
6,1166508,1139.167969,2724,2486,5210,
6,1175976,1148.414063,3356,3129,6485,
6,1185456,1157.671875,2656,2446,5102,
6,1194922,1166.916016,2757,2543,5300,
6,1204390,1176.162109,2549,2322,4871,
6,1213874,1185.423828,2747,2543,5290,
6,1223344,1194.671875,2891,2662,5553,
6,1232808,1203.914063,2911,2691,5602,
6,1242290,1213.173828,2938,2679,5617,
6,1251764,1222.425781,2787,2559,5346,
6,1261238,1231.677734,2726,2454,5180,
6,1270722,1240.939453,2726,2504,5230,
6,1280212,1250.207031,2750,2529,5279,
6,1289692,1259.464844,2974,2377,5351,
6,1299154,1268.705078,3003,2214,5217,
6,1308620,1277.949219,2833,2233,5066,
6,1318094,1287.201172,3350,3109,6459,
6,1327562,1296.447266,2811,2520,5331,
6,1337040,1305.703125,2881,2652,5533,
6,1346524,1314.964844,4969,4721,9690,
6,1355988,1324.207031,3746,3485,7231,
6,1365470,1333.466797,3681,3425,7106,
6,1374950,1342.724609,3818,3551,7369,
6,1384430,1351.982422,3594,3308,6902,
6,1393908,1361.238281,3845,3553,7398,
6,1403388,1370.496094,3670,3408,7078,
6,1412864,1379.75,3652,3381,7033,
6,1422346,1389.009766,4162,3799,7961,
6,1431818,1398.259766,3880,3046,6926,
6,1441290,1407.509766,4222,3124,7346,
6,1450764,1416.761719,3807,3193,7000,
6,1460242,1426.017578,3727,3338,7065,
6,1469712,1435.265625,3897,3603,7500,
6,1479192,1444.523438,3803,3535,7338,
6,1488672,1453.78125,4229,3935,8164,
6,1498148,1463.035156,3960,3675,7635,
6,1507624,1472.289063,3933,3652,7585,
6,1517116,1481.558594,3834,3534,7368,
6,1526602,1490.822266,3752,3446,7198,
6,1536086,1500.083984,3866,3603,7469,
6,1545572,1509.347656,3746,3447,7193,
6,1555048,1518.601563,3811,3532,7343,
6,1564536,1527.867188,3986,3624,7610,
6,1574014,1537.123047,4526,2019,6545,
6,1583486,1546.373047,3790,2590,6380,
6,1592964,1555.628906,3344,3012,6356,
6,1602448,1564.890625,3617,3302,6919,
6,1611920,1574.140625,4155,3850,8005,
6,1621400,1583.398438,3428,3106,6534,
6,1630874,1592.650391,3565,3210,6775,
6,1640350,1601.904297,3588,3272,6860,
6,1649838,1611.169922,3409,3096,6505,
6,1659304,1620.414063,3766,3409,7175,
6,1668782,1629.669922,3546,3243,6789,
6,1678254,1638.919922,4117,3773,7890,
6,1687730,1648.173828,5622,5274,10896,
6,1697208,1657.429688,4813,4497,9310,
6,1706690,1666.689453,5058,4652,9710,BAn20m15 (iteration 1)
6,10268,10.02734375,120,67,187,
6,19738,19.27539063,99,57,156,
6,29212,28.52734375,116,71,187,
6,38678,37.77148438,150,99,249,
6,48150,47.02148438,115,60,175,
6,57628,56.27734375,107,53,160,
6,67088,65.515625,128,74,202,
6,76554,74.75976563,155,81,236,
6,86022,84.00585938,161,75,236,
6,95496,93.2578125,165,65,230,
6,104976,102.515625,113,71,184,
6,114454,111.7714844,94,54,148,
6,123928,121.0234375,103,56,159,
6,133398,130.2714844,125,72,197,
6,142888,139.5390625,114,69,183,
6,152382,148.8105469,248,73,321,
6,161858,158.0644531,323,129,452,
6,171324,167.3085938,237,77,314,
6,180810,176.5722656,209,89,298,
6,190294,185.8339844,162,57,219,
6,199770,195.0878906,202,64,266,
6,209252,204.3476563,172,64,236,
6,218716,213.5898438,2174,2064,4238,
6,228204,222.8554688,202,73,275,
6,237684,232.1132813,1051,924,1975,
6,247150,241.3574219,293,174,467,
6,256632,250.6171875,196,62,258,
6,266104,259.8671875,350,140,490,
6,275578,269.1191406,237,64,301,
6,285048,278.3671875,268,95,363,
6,294540,287.6367188,246,78,324,
6,304014,296.8886719,3665,3503,7168,
6,313486,306.1386719,3875,3747,7622,
6,322970,315.4003906,3437,3289,6726,
6,332436,324.6445313,1069,937,2006,
6,341926,333.9121094,646,497,1143,
6,351394,343.1582031,578,505,1083,
6,360886,352.4277344,596,508,1104,
6,370370,361.6894531,598,518,1116,
6,379856,370.953125,687,612,1299,
6,389316,380.1914063,624,522,1146,
6,398794,389.4472656,645,563,1208,
6,408272,398.703125,740,406,1146,
6,417732,407.9414063,817,486,1303,
6,427198,417.1855469,620,317,937,
6,436674,426.4394531,690,290,980,
6,446140,435.6835938,726,334,1060,
6,455608,444.9296875,691,391,1082,
6,465078,454.1777344,822,459,1281,
6,474546,463.4238281,943,424,1367,
6,484030,472.6855469,727,314,1041,
6,493518,481.9511719,901,328,1229,
6,502998,491.2089844,723,347,1070,
6,512468,500.4570313,787,352,1139,
6,521954,509.7207031,1417,687,2104,
6,531424,518.96875,531,174,705,
6,540894,528.2167969,929,557,1486,
6,550360,537.4609375,1355,356,1711,
6,559822,546.7011719,780,420,1200,
6,569316,555.9726563,882,714,1596,
6,578788,565.2226563,533,386,919,
6,588282,574.4941406,707,597,1304,
6,597762,583.7519531,695,588,1283,
6,607240,593.0078125,748,424,1172,
6,616720,602.265625,842,569,1411,
6,626188,611.5117188,1511,989,2500,
6,635662,620.7636719,1370,813,2183,
6,645148,630.0273438,1150,832,1982,
6,654624,639.28125,1304,912,2216,
6,664108,648.5429688,1504,1264,2768,
6,673580,657.7929688,1640,1409,3049,
6,683052,667.0429688,1346,1188,2534,
6,692520,676.2890625,1342,1198,2540,
6,701976,685.5234375,1770,1631,3401,
6,711464,694.7890625,1272,1133,2405,
6,720956,704.0585938,1618,1469,3087,
6,730428,713.3085938,1563,1372,2935,
6,739918,722.5761719,1186,1038,2224,
6,749390,731.8261719,1708,1550,3258,
6,758860,741.0742188,1673,1525,3198,
6,768338,750.3300781,1490,1337,2827,
6,777808,759.578125,1211,1070,2281,
6,787290,768.8378906,1607,1452,3059,
6,796760,778.0859375,1937,1770,3707,
6,806230,787.3339844,1534,1366,2900,
6,815706,796.5878906,1502,1348,2850,
6,825186,805.8457031,2128,1971,4099,
6,834670,815.1074219,1626,1451,3077,
6,844154,824.3691406,1482,1336,2818,
6,853638,833.6308594,1584,1413,2997,
6,863114,842.8847656,2272,2036,4308,
6,872600,852.1484375,1723,1575,3298,
6,882068,861.3945313,1691,1070,2761,
6,891550,870.6542969,1877,1262,3139,
6,901024,879.90625,1680,1488,3168,
6,910494,889.1542969,1687,1498,3185,
6,919956,898.3945313,2383,2183,4566,
6,929436,907.6523438,2132,1953,4085,
6,938904,916.8984375,2126,1953,4079,
6,948384,926.15625,1953,1734,3687,
6,957868,935.4179688,2135,1962,4097,
6,967328,944.65625,2037,1826,3863,
6,976818,953.9238281,1961,1778,3739,
6,986290,963.1738281,2606,2408,5014,
6,995768,972.4296875,2054,1843,3897,
6,1005248,981.6875,2525,2314,4839,
6,1014736,990.953125,2350,2070,4420,
6,1024212,1000.207031,2482,2290,4772,
6,1033680,1009.453125,3206,2998,6204,
6,1043172,1018.722656,2550,2348,4898,
6,1052654,1027.982422,2794,1240,4034,
6,1062120,1037.226563,2642,1601,4243,
6,1071598,1046.482422,3469,3204,6673,
6,1081072,1055.734375,3181,2697,5878,
6,1090548,1064.988281,2599,1859,4458,
6,1100032,1074.25,2968,2460,5428,
6,1109494,1083.490234,2560,1609,4169,
6,1118970,1092.744141,3259,1135,4394,
6,1128450,1102.001953,2474,2245,4719,
6,1137920,1111.25,6189,988,7177,
6,1147392,1120.5,3095,1521,4616,
6,1156846,1129.732422,2808,2523,5331,
6,1166316,1138.980469,2688,2422,5110,
6,1175820,1148.261719,2963,2450,5413,
6,1185302,1157.521484,3760,3566,7326,
6,1194794,1166.791016,3021,1809,4830,
6,1204286,1176.060547,2755,2546,5301,
6,1213762,1185.314453,3048,790,3838,
6,1223230,1194.560547,3056,2837,5893,
6,1232706,1203.814453,3484,711,4195,
6,1242182,1213.068359,2786,2561,5347,
6,1251666,1222.330078,2752,2538,5290,
6,1261140,1231.582031,3914,1161,5075,
6,1270624,1240.84375,2801,2580,5381,
6,1280102,1250.099609,3072,2840,5912,
6,1289586,1259.361328,4931,1993,6924,
6,1299062,1268.615234,3165,1376,4541,
6,1308532,1277.863281,3113,1767,4880,
6,1317994,1287.103516,2923,2670,5593,
6,1327476,1296.363281,2834,2588,5422,
6,1336946,1305.611328,3277,2990,6267,
6,1346426,1314.869141,5109,4880,9989,
6,1355894,1324.115234,3894,3620,7514,
6,1365382,1333.380859,3676,3421,7097,
6,1374858,1342.634766,3932,3630,7562,
6,1384358,1351.912109,3866,3614,7480,
6,1393830,1361.162109,3973,3725,7698,
6,1403298,1370.408203,3743,3484,7227,
6,1412778,1379.666016,3915,3660,7575,
6,1422246,1388.912109,3949,3696,7645,
6,1431730,1398.173828,4461,2180,6641,
6,1441204,1407.425781,8235,1972,10207,
6,1450684,1416.683594,3962,3532,7494,
6,1460162,1425.939453,4040,3623,7663,
6,1469650,1435.205078,4628,4305,8933,
6,1479116,1444.449219,3898,3590,7488,
6,1488598,1453.708984,3913,3635,7548,
6,1498070,1462.958984,4004,3690,7694,
6,1507552,1472.21875,4097,3726,7823,
6,1517028,1481.472656,4017,3715,7732,
6,1526494,1490.716797,3876,3580,7456,
6,1535966,1499.966797,4630,4339,8969,
6,1545448,1509.226563,3841,3566,7407,
6,1554906,1518.462891,3942,3642,7584,
6,1564376,1527.710938,4046,3738,7784,
6,1573858,1536.970703,6635,2051,8686,
6,1583318,1546.208984,3545,3202,6747,
6,1592808,1555.476563,4140,3820,7960,
6,1602296,1564.742188,3946,3556,7502,
6,1611770,1573.994141,3787,2975,6762,
6,1621246,1583.248047,3801,2749,6550,
6,1630706,1592.486328,3494,3155,6649,
6,1640188,1601.746094,3528,3191,6719,
6,1649664,1611,3463,3139,6602,
6,1659144,1620.257813,3399,3052,6451,
6,1668616,1629.507813,3716,3406,7122,
6,1678104,1638.773438,4185,3732,7917,
6,1687574,1648.021484,5630,5255,10885,
6,1697052,1657.277344,4792,4473,9265,
6,1706534,1666.537109,5028,4636,9664,BAn20m15 (iteration 2)
6,10266,10.02539063,100,65,165,
6,19728,19.265625,104,59,163,
6,29210,28.52539063,113,74,187,
6,38684,37.77734375,88,54,142,
6,48164,47.03515625,116,84,200,
6,57636,56.28515625,95,60,155,
6,67108,65.53515625,116,75,191,
6,76588,74.79296875,120,75,195,
6,86062,84.04492188,126,72,198,
6,95538,93.29882813,121,69,190,
6,105016,102.5546875,192,129,321,
6,114490,111.8066406,99,59,158,
6,123964,121.0585938,116,72,188,
6,133436,130.3085938,180,131,311,
6,142906,139.5566406,113,63,176,
6,152384,148.8125,195,80,275,
6,161854,158.0605469,183,100,283,
6,171332,167.3164063,148,64,212,
6,180802,176.5644531,188,80,268,
6,190296,185.8359375,177,82,259,
6,199784,195.1015625,183,77,260,
6,209268,204.3632813,224,90,314,
6,218750,213.6230469,265,148,413,
6,228234,222.8847656,195,75,270,
6,237710,232.1386719,1092,976,2068,
6,247184,241.390625,3541,3389,6930,
6,256666,250.6503906,241,101,342,
6,266128,259.890625,300,154,454,
6,275602,269.1425781,168,74,242,
6,285092,278.4101563,4482,4403,8885,
6,294586,287.6816406,1301,1219,2520,
6,304062,296.9355469,690,623,1313,
6,313544,306.1953125,9860,9793,19653,
6,323014,315.4433594,963,880,1843,
6,332490,324.6972656,729,570,1299,
6,341954,333.9394531,562,402,964,
6,351442,343.2050781,558,423,981,
6,360932,352.4726563,597,516,1113,
6,370404,361.7226563,523,454,977,
6,379874,370.9707031,585,514,1099,
6,389342,380.2167969,693,615,1308,
6,398826,389.4785156,622,544,1166,
6,408300,398.7304688,925,540,1465,
6,417796,408.0039063,783,509,1292,
6,427272,417.2578125,610,314,924,
6,436748,426.5117188,627,377,1004,
6,446232,435.7734375,779,523,1302,
6,455708,445.0273438,692,434,1126,
6,465184,454.28125,783,492,1275,
6,474656,463.53125,721,426,1147,
6,484126,472.7792969,724,433,1157,
6,493610,482.0410156,770,450,1220,
6,503086,491.2949219,732,409,1141,
6,512574,500.5605469,858,590,1448,
6,522060,509.8242188,650,511,1161,
6,531548,519.0898438,855,597,1452,
6,541040,528.359375,674,346,1020,
6,550506,537.6035156,967,672,1639,
6,559976,546.8515625,724,419,1143,
6,569460,556.1132813,850,517,1367,
6,578940,565.3710938,820,570,1390,
6,588412,574.6210938,289,182,471,
6,597880,583.8671875,804,692,1496,
6,607364,593.1289063,752,642,1394,
6,616834,602.3769531,719,593,1312,
6,626312,611.6328125,1615,1183,2798,
6,635796,620.8945313,1353,1037,2390,
6,645264,630.140625,1140,1027,2167,
6,654752,639.40625,1364,1233,2597,
6,664230,648.6621094,1433,1229,2662,
6,673710,657.9199219,1363,1091,2454,
6,683178,667.1660156,1410,1269,2679,
6,692660,676.4257813,1242,1130,2372,
6,702130,685.6738281,1276,1162,2438,
6,711606,694.9277344,1342,1227,2569,
6,721072,704.171875,1722,1463,3185,
6,730564,713.4414063,1437,1267,2704,
6,740052,722.7070313,1264,1110,2374,
6,749520,731.953125,1448,1304,2752,
6,759006,741.2167969,1473,1347,2820,
6,768480,750.46875,1472,1325,2797,
6,777972,759.7382813,1474,1350,2824,
6,787436,768.9804688,1530,1367,2897,
6,796916,778.2382813,1411,1281,2692,
6,806390,787.4902344,1890,1551,3441,
6,815866,796.7441406,1537,1247,2784,
6,825344,806,1245,1108,2353,
6,834822,815.2558594,1513,1360,2873,
6,844304,824.515625,1507,1356,2863,
6,853778,833.7675781,1569,1439,3008,
6,863246,843.0136719,2008,1736,3744,
6,872720,852.265625,1514,1358,2872,
6,882190,861.5136719,1839,1657,3496,
6,891670,870.7714844,1735,1421,3156,
6,901154,880.0332031,1679,1251,2930,
6,910622,889.2792969,1652,1455,3107,
6,920096,898.53125,2538,2365,4903,
6,929572,907.7851563,1999,1839,3838,
6,939054,917.0449219,1930,1764,3694,
6,948526,926.2949219,1901,1488,3389,
6,958014,935.5605469,2041,1856,3897,
6,967488,944.8125,2201,2035,4236,
6,976964,954.0664063,2023,1839,3862,
6,986438,963.3183594,2089,1922,4011,
6,995930,972.5878906,2032,1820,3852,
6,1005424,981.859375,2847,2510,5357,
6,1014916,991.1289063,2126,1945,4071,
6,1024380,1000.371094,2447,2270,4717,
6,1033842,1009.611328,2569,2402,4971,
6,1043326,1018.873047,2439,2262,4701,
6,1052796,1028.121094,2783,1619,4402,
6,1062274,1037.376953,2917,1903,4820,
6,1071754,1046.634766,2650,1678,4328,
6,1081224,1055.882813,2400,2196,4596,
6,1090688,1065.125,2485,2281,4766,
6,1100170,1074.384766,3338,3144,6482,
6,1109650,1083.642578,2450,2269,4719,
6,1119140,1092.910156,2716,2179,4895,
6,1128610,1102.158203,2613,2418,5031,
6,1138082,1111.408203,5052,1221,6273,
6,1147566,1120.669922,3284,2664,5948,
6,1157052,1129.933594,2713,2300,5013,
6,1166518,1139.177734,2859,2283,5142,
6,1176002,1148.439453,2778,2543,5321,
6,1185484,1157.699219,2730,2519,5249,
6,1194970,1166.962891,2620,2427,5047,
6,1204452,1176.222656,2727,2531,5258,
6,1213944,1185.492188,2704,2491,5195,
6,1223430,1194.755859,2682,2481,5163,
6,1232910,1204.013672,2689,2440,5129,
6,1242374,1213.255859,2733,2528,5261,
6,1251838,1222.498047,2771,2510,5281,
6,1261316,1231.753906,3602,3368,6970,
6,1270776,1240.992188,2761,2538,5299,
6,1280244,1250.238281,2845,2597,5442,
6,1289710,1259.482422,2805,2250,5055,
6,1299194,1268.744141,2809,2501,5310,
6,1308672,1278,3328,2211,5539,
6,1318150,1287.255859,2775,2498,5273,
6,1327628,1296.511719,2792,2477,5269,
6,1337096,1305.757813,2884,2615,5499,
6,1346576,1315.015625,4941,4708,9649,
6,1356052,1324.269531,3801,3564,7365,
6,1365532,1333.527344,3731,3476,7207,
6,1375014,1342.787109,3789,3549,7338,
6,1384492,1352.042969,3794,3543,7337,
6,1393962,1361.291016,3840,3589,7429,
6,1403428,1370.535156,4336,4054,8390,
6,1412912,1379.796875,3875,3608,7483,
6,1422392,1389.054688,3782,3523,7305,
6,1431862,1398.302734,3840,3507,7347,
6,1441342,1407.560547,3893,3563,7456,
6,1450814,1416.810547,3713,3439,7152,
6,1460284,1426.058594,4004,3751,7755,
6,1469750,1435.302734,3781,3507,7288,
6,1479238,1444.568359,3796,3545,7341,
6,1488730,1453.837891,3963,3616,7579,
6,1498210,1463.095703,3821,3545,7366,
6,1507692,1472.355469,3922,3630,7552,
6,1517158,1481.599609,3909,3621,7530,
6,1526626,1490.845703,4212,3897,8109,
6,1536108,1500.105469,3897,3612,7509,
6,1545568,1509.34375,3958,3647,7605,
6,1555046,1518.599609,4500,4213,8713,
6,1564518,1527.849609,4597,4242,8839,
6,1573984,1537.09375,3657,2423,6080,
6,1583462,1546.349609,3460,3132,6592,
6,1592944,1555.609375,3257,2909,6166,
6,1602404,1564.847656,3498,3187,6685,
6,1611876,1574.097656,3332,3010,6342,
6,1621362,1583.361328,3352,3054,6406,
6,1630844,1592.621094,3470,3141,6611,
6,1640324,1601.878906,3400,3099,6499,
6,1649788,1611.121094,3910,3576,7486,
6,1659262,1620.373047,3849,2203,6052,
6,1668748,1629.636719,3524,3171,6695,
6,1678222,1638.888672,4266,2833,7099,
6,1687702,1648.146484,5856,3870,9726,
6,1697172,1657.394531,4681,4302,8983,
6,1706650,1666.650391,4577,4198,8775,BAn20m15 (iteration 3)
6,10274,10.03320313,94,61,155,
6,19730,19.26757813,105,60,165,
6,29202,28.51757813,105,66,171,
6,38670,37.76367188,103,65,168,
6,48156,47.02734375,114,75,189,
6,57624,56.2734375,95,56,151,
6,67100,65.52734375,121,84,205,
6,76566,74.77148438,98,59,157,
6,86052,84.03515625,92,54,146,
6,95522,93.28320313,115,65,180,
6,104996,102.5351563,104,64,168,
6,114468,111.7851563,129,80,209,
6,123942,121.0371094,151,87,238,
6,133412,130.2851563,175,113,288,
6,142896,139.546875,100,58,158,
6,152360,148.7890625,129,66,195,
6,161816,158.0234375,124,76,200,
6,171298,167.2832031,123,67,190,
6,180768,176.53125,141,74,215,
6,190240,185.78125,114,57,171,
6,199708,195.0273438,242,186,428,
6,209190,204.2871094,120,67,187,
6,218662,213.5371094,114,64,178,
6,228142,222.7949219,255,168,423,
6,237616,232.046875,134,70,204,
6,247096,241.3046875,910,843,1753,
6,256578,250.5644531,4281,4165,8446,
6,266054,259.8183594,794,716,1510,
6,275538,269.0800781,178,110,288,
6,285018,278.3378906,4862,4772,9634,
6,294506,287.6035156,701,627,1328,
6,303978,296.8535156,882,818,1700,
6,313470,306.1230469,650,577,1227,
6,322952,315.3828125,1353,1291,2644,
6,332418,324.6269531,454,355,809,
6,341904,333.890625,687,601,1288,
6,351398,343.1621094,588,508,1096,
6,360870,352.4121094,1054,976,2030,
6,370350,361.6699219,527,464,991,
6,379836,370.9335938,744,667,1411,
6,389324,380.1992188,423,358,781,
6,398814,389.4667969,3762,3677,7439,
6,408294,398.7246094,988,865,1853,
6,417776,407.984375,810,702,1512,
6,427260,417.2460938,653,441,1094,
6,436750,426.5136719,594,438,1032,
6,446248,435.7890625,829,578,1407,
6,455738,445.0566406,745,504,1249,
6,465218,454.3144531,688,588,1276,
6,474696,463.5703125,618,521,1139,
6,484166,472.8183594,783,693,1476,
6,493654,482.0839844,761,625,1386,
6,503140,491.3476563,622,535,1157,
6,512622,500.6074219,714,604,1318,
6,522112,509.875,757,503,1260,
6,531590,519.1308594,813,685,1498,
6,541078,528.3964844,869,746,1615,
6,550564,537.6601563,703,581,1284,
6,560036,546.9101563,560,425,985,
6,569514,556.1660156,674,560,1234,
6,578998,565.4277344,674,571,1245,
6,588492,574.6992188,720,588,1308,
6,597974,583.9589844,747,512,1259,
6,607454,593.2167969,783,655,1438,
6,616926,602.4667969,749,641,1390,
6,626398,611.7167969,1576,1068,2644,
6,635854,620.9511719,1169,1056,2225,
6,645324,630.1992188,1315,1204,2519,
6,654802,639.4550781,1148,1030,2178,
6,664266,648.6972656,1383,1260,2643,
6,673742,657.9511719,1449,1292,2741,
6,683220,667.2070313,1331,1188,2519,
6,692706,676.4707031,1323,1214,2537,
6,702184,685.7265625,1364,1252,2616,
6,711664,694.984375,1230,1123,2353,
6,721144,704.2421875,1678,1551,3229,
6,730642,713.5175781,1505,1368,2873,
6,740110,722.7636719,1538,1397,2935,
6,749584,732.015625,1382,1248,2630,
6,759056,741.265625,1465,1333,2798,
6,768540,750.5273438,1245,1115,2360,
6,778026,759.7910156,1672,1536,3208,
6,787510,769.0527344,1983,1845,3828,
6,796992,778.3125,1754,1619,3373,
6,806458,787.5566406,1469,1314,2783,
6,815932,796.8085938,1717,1404,3121,
6,825406,806.0605469,1542,1394,2936,
6,834892,815.3242188,1600,1424,3024,
6,844372,824.5820313,1534,1399,2933,
6,853852,833.8398438,1512,1371,2883,
6,863320,843.0859375,1947,1807,3754,
6,872786,852.3300781,1544,1391,2935,
6,882262,861.5839844,1564,1362,2926,
6,891732,870.8320313,1568,1396,2964,
6,901206,880.0839844,1972,1678,3650,
6,910678,889.3339844,1305,1124,2429,
6,920166,898.5996094,2578,2396,4974,
6,929632,907.84375,2300,2151,4451,
6,939118,917.1074219,1926,1780,3706,
6,948590,926.3574219,2096,1797,3893,
6,958066,935.6113281,2391,1468,3859,
6,967534,944.8574219,2276,1019,3295,
6,977018,954.1191406,2089,1509,3598,
6,986488,963.3671875,2307,1483,3790,
6,995956,972.6132813,2007,1844,3851,
6,1005434,981.8691406,2413,2244,4657,
6,1014912,991.125,2617,2444,5061,
6,1024378,1000.369141,2376,2191,4567,
6,1033844,1009.613281,2482,2309,4791,
6,1043324,1018.871094,2398,2219,4617,
6,1052806,1028.130859,2794,2137,4931,
6,1062286,1037.388672,2711,1071,3782,
6,1071766,1046.646484,2878,2664,5542,
6,1081236,1055.894531,2482,2229,4711,
6,1090712,1065.148438,2594,2379,4973,
6,1100188,1074.402344,2635,2448,5083,
6,1109656,1083.648438,2510,2324,4834,
6,1119130,1092.900391,2910,2671,5581,
6,1128606,1102.154297,2579,2380,4959,
6,1138090,1111.416016,5948,1889,7837,
6,1147568,1120.671875,2988,1888,4876,
6,1157040,1129.921875,3309,1304,4613,
6,1166508,1139.167969,2840,2558,5398,
6,1175992,1148.429688,2737,2468,5205,
6,1185472,1157.6875,2809,2586,5395,
6,1194950,1166.943359,2771,2558,5329,
6,1204434,1176.205078,2911,2687,5598,
6,1213906,1185.455078,2661,2457,5118,
6,1223382,1194.708984,2769,2560,5329,
6,1232870,1203.974609,2730,2516,5246,
6,1242342,1213.224609,2915,2701,5616,
6,1251812,1222.472656,2732,2525,5257,
6,1261300,1231.738281,2806,2554,5360,
6,1270768,1240.984375,2897,2659,5556,
6,1280228,1250.222656,2944,2679,5623,
6,1289702,1259.474609,2771,2506,5277,
6,1299166,1268.716797,3034,2694,5728,
6,1308632,1277.960938,3060,2779,5839,
6,1318102,1287.208984,2949,2632,5581,
6,1327582,1296.466797,2869,2641,5510,
6,1337046,1305.708984,3046,2806,5852,
6,1346524,1314.964844,5036,4794,9830,
6,1355992,1324.210938,3952,3724,7676,
6,1365476,1333.472656,3814,3574,7388,
6,1374962,1342.736328,3741,3461,7202,
6,1384432,1351.984375,3818,3573,7391,
6,1393906,1361.236328,4028,3759,7787,
6,1403394,1370.501953,3735,3493,7228,
6,1412876,1379.761719,3962,3719,7681,
6,1422346,1389.009766,3812,3575,7387,
6,1431830,1398.271484,3988,3689,7677,
6,1441310,1407.529297,3953,3634,7587,
6,1450784,1416.78125,3950,3676,7626,
6,1460266,1426.041016,4036,3712,7748,
6,1469752,1435.304688,3998,3635,7633,
6,1479238,1444.568359,4002,3712,7714,
6,1488700,1453.808594,4054,3771,7825,
6,1498174,1463.060547,3906,3639,7545,
6,1507672,1472.335938,4000,3735,7735,
6,1517154,1481.595703,3946,3675,7621,
6,1526636,1490.855469,4065,3783,7848,
6,1536124,1500.121094,3973,3630,7603,
6,1545606,1509.380859,3934,3664,7598,
6,1555088,1518.640625,3982,3710,7692,
6,1564556,1527.886719,3977,3695,7672,
6,1574026,1537.134766,4022,3665,7687,
6,1583508,1546.394531,3351,3002,6353,
6,1592970,1555.634766,3523,3242,6765,
6,1602440,1564.882813,3654,3332,6986,
6,1611916,1574.136719,3451,3140,6591,
6,1621388,1583.386719,3490,3199,6689,
6,1630874,1592.650391,3558,3228,6786,
6,1640360,1601.914063,3419,3099,6518,
6,1649816,1611.148438,3527,3208,6735,
6,1659302,1620.412109,3673,3286,6959,
6,1668776,1629.664063,3502,3161,6663,
6,1678256,1638.921875,4185,3858,8043,
6,1687728,1648.171875,5486,5156,10642,
6,1697204,1657.425781,4733,4401,9134,
6,1706678,1666.677734,4563,4235,8798,BAn20m15 (iteration 4)
6,10262,10.02148438,120,67,187,
6,19736,19.2734375,122,70,192,
6,29218,28.53320313,108,67,175,
6,38688,37.78125,90,57,147,
6,48164,47.03515625,99,67,166,
6,57636,56.28515625,112,66,178,
6,67108,65.53515625,119,78,197,
6,76598,74.80273438,128,81,209,
6,86070,84.05273438,119,72,191,
6,95542,93.30273438,117,66,183,
6,105020,102.5585938,116,71,187,
6,114498,111.8144531,106,63,169,
6,123978,121.0722656,113,69,182,
6,133468,130.3398438,155,91,246,
6,142954,139.6035156,102,57,159,
6,152442,148.8691406,206,80,286,
6,161928,158.1328125,264,106,370,
6,171416,167.3984375,279,108,387,
6,180902,176.6621094,223,90,313,
6,190378,185.9160156,221,94,315,
6,199856,195.171875,210,65,275,
6,209342,204.4355469,188,89,277,
6,218818,213.6894531,3449,3326,6775,
6,228290,222.9394531,223,72,295,
6,237762,232.1894531,270,121,391,
6,247234,241.4394531,250,98,348,
6,256700,250.6835938,427,290,717,
6,266162,259.9238281,277,137,414,
6,275648,269.1875,266,183,449,
6,285140,278.4570313,1134,920,2054,
6,294608,287.703125,497,351,848,
6,304086,296.9589844,1154,980,2134,
6,313558,306.2089844,4545,4382,8927,
6,323036,315.4648438,2235,2081,4316,
6,332522,324.7285156,3648,3411,7059,
6,341994,333.9785156,2264,2180,4444,
6,351484,343.2460938,857,784,1641,
6,360970,352.5097656,625,551,1176,
6,370458,361.7753906,562,492,1054,
6,379944,371.0390625,684,600,1284,
6,389400,380.2734375,610,527,1137,
6,398886,389.5371094,580,491,1071,
6,408368,398.796875,765,521,1286,
6,417832,408.0390625,750,495,1245,
6,427316,417.3007813,653,404,1057,
6,436802,426.5644531,720,477,1197,
6,446276,435.8164063,652,403,1055,
6,455754,445.0722656,646,393,1039,
6,465242,454.3378906,774,502,1276,
6,474716,463.5898438,755,479,1234,
6,484194,472.8457031,791,423,1214,
6,493664,482.09375,708,399,1107,
6,503124,491.3320313,698,430,1128,
6,512602,500.5878906,628,523,1151,
6,522076,509.8398438,720,367,1087,
6,531564,519.1054688,750,415,1165,
6,541038,528.3574219,643,321,964,
6,550516,537.6132813,848,433,1281,
6,560010,546.8847656,755,389,1144,
6,569486,556.1386719,879,460,1339,
6,578978,565.4082031,789,390,1179,
6,588436,574.6445313,960,525,1485,
6,597910,583.8964844,385,264,649,
6,607392,593.15625,716,591,1307,
6,616868,602.4101563,789,693,1482,
6,626342,611.6621094,1550,1140,2690,
6,635814,620.9121094,1227,826,2053,
6,645280,630.15625,1109,833,1942,
6,654764,639.4179688,1120,776,1896,
6,664248,648.6796875,1624,1224,2848,
6,673720,657.9296875,1489,1339,2828,
6,683186,667.1738281,1138,1008,2146,
6,692658,676.4238281,1617,1503,3120,
6,702142,685.6855469,1250,1145,2395,
6,711630,694.9511719,1258,1153,2411,
6,721108,704.2070313,1677,1318,2995,
6,730574,713.4511719,1515,1360,2875,
6,740048,722.703125,1142,1018,2160,
6,749526,731.9589844,1476,1345,2821,
6,759008,741.21875,1592,1462,3054,
6,768486,750.4746094,1731,1560,3291,
6,777982,759.7480469,1412,1289,2701,
6,787464,769.0078125,1458,1318,2776,
6,796940,778.2617188,1634,1385,3019,
6,806426,787.5253906,1517,1066,2583,
6,815908,796.7851563,1274,1101,2375,
6,825402,806.0566406,1567,1433,3000,
6,834888,815.3203125,1573,1420,2993,
6,844372,824.5820313,1772,1649,3421,
6,853856,833.84375,1567,1430,2997,
6,863330,843.0957031,1652,1524,3176,
6,872794,852.3378906,1290,1168,2458,
6,882280,861.6015625,1871,1272,3143,
6,891758,870.8574219,1719,1157,2876,
6,901224,880.1015625,1669,1285,2954,
6,910690,889.3457031,1285,1138,2423,
6,920174,898.6074219,2646,2507,5153,
6,929660,907.8710938,2428,2269,4697,
6,939132,917.1210938,1908,1772,3680,
6,948602,926.3691406,2027,1397,3424,
6,958084,935.6289063,1930,1701,3631,
6,967578,944.9003906,1968,1761,3729,
6,977054,954.1542969,2025,1860,3885,
6,986534,963.4121094,2203,2035,4238,
6,996004,972.6601563,2009,1806,3815,
6,1005484,981.9179688,2279,2086,4365,
6,1014956,991.1679688,2457,2290,4747,
6,1024432,1000.421875,2475,2264,4739,
6,1033904,1009.671875,2473,2204,4677,
6,1043370,1018.916016,2305,2144,4449,
6,1052858,1028.181641,2434,1982,4416,
6,1062318,1037.419922,2459,2213,4672,
6,1071798,1046.677734,2517,2287,4804,
6,1081276,1055.933594,2594,2205,4799,
6,1090752,1065.1875,2425,2231,4656,
6,1100218,1074.431641,2559,2298,4857,
6,1109692,1083.683594,2562,2391,4953,
6,1119184,1092.953125,2539,2316,4855,
6,1128664,1102.210938,2477,2289,4766,
6,1138134,1111.458984,2910,1180,4090,
6,1147604,1120.707031,2710,2490,5200,
6,1157078,1129.958984,2661,2447,5108,
6,1166560,1139.21875,2570,2371,4941,
6,1176032,1148.46875,2777,2581,5358,
6,1185520,1157.734375,2725,2503,5228,
6,1195004,1166.996094,2884,2629,5513,
6,1204480,1176.25,2716,2461,5177,
6,1213966,1185.513672,2854,2603,5457,
6,1223448,1194.773438,2767,2520,5287,
6,1232922,1204.025391,2746,2447,5193,
6,1242396,1213.277344,2684,2465,5149,
6,1251862,1222.521484,2746,2441,5187,
6,1261334,1231.771484,2948,2685,5633,
6,1270822,1241.037109,2733,2490,5223,
6,1280296,1250.289063,2878,2653,5531,
6,1289780,1259.550781,2861,2587,5448,
6,1299248,1268.796875,2977,2680,5657,
6,1308734,1278.060547,2760,2475,5235,
6,1318200,1287.304688,2839,2615,5454,
6,1327688,1296.570313,2851,2596,5447,
6,1337170,1305.830078,2959,2744,5703,
6,1346660,1315.097656,4823,4607,9430,
6,1356128,1324.34375,3735,3503,7238,
6,1365612,1333.605469,3740,3477,7217,
6,1375086,1342.857422,3841,3618,7459,
6,1384560,1352.109375,3723,3502,7225,
6,1394042,1361.369141,3587,3340,6927,
6,1403510,1370.615234,3852,3628,7480,
6,1412980,1379.863281,3859,3615,7474,
6,1422450,1389.111328,3697,3460,7157,
6,1431940,1398.378906,3379,3077,6456,
6,1441414,1407.630859,3686,3384,7070,
6,1450888,1416.882813,3813,3547,7360,
6,1460354,1426.126953,3841,3575,7416,
6,1469828,1435.378906,3791,3529,7320,
6,1479304,1444.632813,3911,3646,7557,
6,1488780,1453.886719,3682,3415,7097,
6,1498262,1463.146484,3891,3629,7520,
6,1507724,1472.386719,3936,3662,7598,
6,1517186,1481.626953,3776,3489,7265,
6,1526674,1490.892578,4113,3822,7935,
6,1536146,1500.142578,3866,3579,7445,
6,1545624,1509.398438,3960,3693,7653,
6,1555100,1518.652344,3919,3666,7585,
6,1564584,1527.914063,3895,3587,7482,
6,1574054,1537.162109,3567,3134,6701,
6,1583528,1546.414063,3198,2906,6104,
6,1593018,1555.681641,3375,3079,6454,
6,1602498,1564.939453,3537,3250,6787,
6,1611982,1574.201172,3316,2987,6303,
6,1621474,1583.470703,3533,3226,6759,
6,1630946,1592.720703,3370,3084,6454,
6,1640442,1601.994141,3365,3026,6391,
6,1649918,1611.248047,3451,3108,6559,
6,1659392,1620.5,3433,3067,6500,
6,1668872,1629.757813,3389,3042,6431,
6,1678348,1639.011719,4065,3744,7809,
6,1687834,1648.275391,5555,5168,10723,
6,1697302,1657.521484,4588,4215,8803,
6,1706780,1666.777344,4593,4197,8790,BAn20m15 (iteration 5)
10,15178,14.82226563,137,82,219,
10,29558,28.86523438,200,136,336,
10,43946,42.91601563,200,116,316,
10,58316,56.94921875,148,92,240,
10,72686,70.98242188,148,98,246,
10,87054,85.01367188,151,90,241,
10,101438,99.06054688,198,111,309,
10,115802,113.0878906,179,97,276,
10,130184,127.1328125,221,140,361,
10,144564,141.1757813,296,187,483,
10,158956,155.2304688,183,101,284,
10,173344,169.28125,218,117,335,
10,187720,183.3203125,685,591,1276,
10,202094,197.3574219,206,126,332,
10,216468,211.3945313,642,529,1171,
10,230826,225.4160156,1392,1252,2644,
10,245210,239.4628906,192,110,302,
10,259586,253.5019531,272,126,398,
10,273960,267.5390625,208,107,315,
10,288334,281.5761719,554,410,964,
10,302710,295.6152344,295,171,466,
10,317094,309.6621094,1489,1327,2816,
10,331492,323.7226563,690,577,1267,
10,345856,337.75,189,102,291,
10,360230,351.7871094,616,494,1110,
10,374604,365.8242188,769,622,1391,
10,388982,379.8652344,727,620,1347,
10,403344,393.890625,473,319,792,
10,417712,407.921875,698,550,1248,
10,432090,421.9628906,567,455,1022,
10,446464,436,654,512,1166,
10,460846,450.0449219,648,526,1174,
10,475226,464.0878906,781,663,1444,
10,489602,478.1269531,665,501,1166,
10,503984,492.171875,711,558,1269,
10,518352,506.203125,529,416,945,
10,532728,520.2421875,648,508,1156,BAn20m2 (iteration 1)
10,15158,14.80273438,144,89,233,
10,29522,28.83007813,149,82,231,
10,43884,42.85546875,174,118,292,
10,58250,56.88476563,156,99,255,
10,72632,70.9296875,131,91,222,
10,87008,84.96875,129,75,204,
10,101390,99.01367188,146,103,249,
10,115770,113.0566406,167,89,256,
10,130150,127.0996094,139,83,222,
10,144528,141.140625,181,83,264,
10,158916,155.1914063,187,116,303,
10,173276,169.2148438,937,872,1809,
10,187650,183.2519531,171,89,260,
10,202018,197.2832031,178,101,279,
10,216390,211.3183594,161,92,253,
10,230756,225.3476563,141,81,222,
10,245154,239.4082031,210,137,347,
10,259522,253.4394531,182,91,273,
10,273894,267.4746094,166,89,255,
10,288284,281.5273438,218,129,347,
10,302652,295.5585938,200,109,309,
10,317026,309.5957031,342,254,596,
10,331418,323.6503906,1869,1784,3653,
10,345790,337.6855469,546,432,978,
10,360170,351.7285156,232,128,360,
10,374534,365.7558594,489,389,878,
10,388906,379.7910156,927,815,1742,
10,403290,393.8378906,455,324,779,
10,417668,407.8789063,462,356,818,
10,432054,421.9277344,562,423,985,
10,446430,435.9667969,550,458,1008,
10,460804,450.0039063,486,393,879,
10,475180,464.0429688,661,562,1223,
10,489550,478.0761719,739,609,1348,
10,503918,492.1074219,547,439,986,
10,518306,506.1582031,1011,905,1916,
10,532680,520.1953125,332,191,523,BAn20m2 (iteration 2)
10,15168,14.8125,134,92,226,
10,29548,28.85546875,163,112,275,
10,43924,42.89453125,210,155,365,
10,58298,56.93164063,122,91,213,
10,72670,70.96679688,171,105,276,
10,87042,85.00195313,209,137,346,
10,101402,99.02539063,157,99,256,
10,115766,113.0527344,146,91,237,
10,130130,127.0800781,171,113,284,
10,144502,141.1152344,149,87,236,
10,158886,155.1621094,699,641,1340,
10,173262,169.2011719,345,278,623,
10,187644,183.2460938,156,94,250,
10,202030,197.2949219,171,107,278,
10,216396,211.3242188,667,612,1279,
10,230772,225.3632813,142,79,221,
10,245152,239.40625,202,118,320,
10,259524,253.4414063,226,132,358,
10,273902,267.4824219,220,136,356,
10,288284,281.5273438,179,93,272,
10,302670,295.5761719,614,552,1166,
10,317046,309.6152344,1786,1709,3495,
10,331410,323.6425781,474,392,866,
10,345778,337.6738281,507,415,922,
10,360156,351.7148438,612,520,1132,
10,374524,365.7460938,584,503,1087,
10,388906,379.7910156,692,603,1295,
10,403280,393.828125,697,623,1320,
10,417658,407.8691406,257,172,429,
10,432034,421.9082031,406,321,727,
10,446412,435.9492188,578,493,1071,
10,460790,449.9902344,587,478,1065,
10,475170,464.0332031,748,644,1392,
10,489548,478.0742188,765,637,1402,
10,503918,492.1074219,515,402,917,
10,518306,506.1582031,609,495,1104,
10,532694,520.2089844,886,782,1668,BAn20m2 (iteration 3)
10,15178,14.82226563,111,65,176,
10,29542,28.84960938,163,115,278,
10,43922,42.89257813,133,85,218,
10,58290,56.92382813,140,82,222,
10,72672,70.96875,125,93,218,
10,87046,85.00585938,127,94,221,
10,101418,99.04101563,143,107,250,
10,115802,113.0878906,168,104,272,
10,130166,127.1152344,315,249,564,
10,144536,141.1484375,134,95,229,
10,158912,155.1875,231,177,408,
10,173286,169.2246094,155,95,250,
10,187672,183.2734375,182,125,307,
10,202046,197.3105469,989,914,1903,
10,216422,211.3496094,142,85,227,
10,230798,225.3886719,308,250,558,
10,245178,239.4316406,178,80,258,
10,259550,253.4667969,189,113,302,
10,273916,267.4960938,156,99,255,
10,288298,281.5410156,219,125,344,
10,302664,295.5703125,200,106,306,
10,317052,309.6210938,1020,937,1957,
10,331426,323.6582031,1578,1495,3073,
10,345824,337.71875,486,397,883,
10,360202,351.7597656,434,356,790,
10,374578,365.7988281,473,360,833,
10,388952,379.8359375,475,384,859,
10,403320,393.8671875,694,611,1305,
10,417694,407.9042969,728,634,1362,
10,432066,421.9394531,419,329,748,
10,446448,435.984375,810,696,1506,
10,460840,450.0390625,564,481,1045,
10,475204,464.0664063,863,728,1591,
10,489574,478.0996094,1216,1127,2343,
10,503948,492.1367188,304,206,510,
10,518326,506.1777344,1111,978,2089,
10,532694,520.2089844,362,264,626,BAn20m2 (iteration 4)
10,15158,14.80273438,125,71,196,
10,29530,28.83789063,140,97,237,
10,43894,42.86523438,148,91,239,
10,58262,56.89648438,162,107,269,
10,72642,70.93945313,144,91,235,
10,87018,84.97851563,156,102,258,
10,101388,99.01171875,138,89,227,
10,115766,113.0527344,154,91,245,
10,130128,127.078125,142,90,232,
10,144518,141.1308594,142,86,228,
10,158890,155.1660156,532,478,1010,
10,173266,169.2050781,154,97,251,
10,187628,183.2304688,147,85,232,
10,201998,197.2636719,156,92,248,
10,216376,211.3046875,157,89,246,
10,230746,225.3378906,407,339,746,
10,245110,239.3652344,188,112,300,
10,259500,253.4179688,1588,1523,3111,
10,273872,267.453125,155,86,241,
10,288248,281.4921875,162,94,256,
10,302622,295.5292969,203,112,315,
10,316996,309.5664063,783,682,1465,
10,331370,323.6035156,735,656,1391,
10,345754,337.6503906,573,470,1043,
10,360126,351.6855469,607,513,1120,
10,374482,365.7050781,708,611,1319,
10,388856,379.7421875,382,298,680,
10,403228,393.7773438,515,399,914,
10,417584,407.796875,540,458,998,
10,431956,421.8320313,569,456,1025,
10,446334,435.8730469,716,606,1322,
10,460694,449.8964844,709,622,1331,
10,475074,463.9394531,623,482,1105,
10,489446,477.9746094,733,628,1361,
10,503824,492.015625,635,530,1165,
10,518202,506.0566406,567,438,1005,
10,532562,520.0800781,692,529,1221,BAn20m2 (iteration 5)
10,15166,14.81054688,139,99,238,
10,29540,28.84765625,126,84,210,
10,43914,42.88476563,130,83,213,
10,58298,56.93164063,131,84,215,
10,72676,70.97265625,137,89,226,
10,87052,85.01171875,147,104,251,
10,101420,99.04296875,135,90,225,
10,115794,113.0800781,135,80,215,
10,130172,127.1210938,127,80,207,
10,145240,141.8359375,315,91,406,
10,160312,156.5546875,1313,1255,2568,
10,175390,171.2792969,141,89,230,
10,190478,186.0136719,133,76,209,
10,205542,200.7246094,585,526,1111,
10,220608,215.4375,527,461,988,
10,234990,229.4824219,162,89,251,
10,249364,243.5195313,143,80,223,
10,263742,257.5605469,174,99,273,
10,278124,271.6054688,167,102,269,
10,292516,285.6601563,141,82,223,
10,306882,299.6894531,168,95,263,
10,321262,313.7324219,528,458,986,
10,335632,327.765625,901,840,1741,
10,350008,341.8046875,496,417,913,
10,364394,355.8535156,639,548,1187,
10,378776,369.8984375,563,469,1032,
10,393148,383.9335938,754,537,1291,
10,407516,397.9648438,751,666,1417,
10,421878,411.9902344,509,417,926,
10,436252,426.0273438,721,641,1362,
10,450614,440.0527344,443,332,775,
10,465000,454.1015625,336,254,590,
10,479374,468.1386719,842,651,1493,
10,493764,482.1914063,770,684,1454,
10,508124,496.2148438,649,550,1199,
10,522504,510.2578125,602,503,1105,
10,536888,524.3046875,715,592,1307,
10,551274,538.3535156,730,634,1364,
10,565656,552.3984375,742,619,1361,
10,580034,566.4394531,709,572,1281,
10,594420,580.4882813,783,656,1439,
10,608792,594.5234375,797,696,1493,
10,623160,608.5546875,902,673,1575,
10,637534,622.5917969,643,537,1180,
10,651910,636.6308594,1713,1613,3326,
10,666288,650.671875,1272,1157,2429,
10,680660,664.7070313,1285,1161,2446,
10,695022,678.7324219,1331,1171,2502,
10,709398,692.7714844,1327,1213,2540,
10,723782,706.8183594,1104,995,2099,
10,738148,720.8476563,1384,1264,2648,
10,752520,734.8828125,1392,1267,2659,
10,766898,748.9238281,1356,1202,2558,
10,781270,762.9589844,1865,1536,3401,
10,795642,776.9941406,1054,927,1981,
10,810014,791.0292969,1238,1098,2336,
10,824380,805.0585938,1296,1065,2361,
10,838754,819.0957031,1035,883,1918,
10,853138,833.1425781,1532,1289,2821,
10,867516,847.1835938,1022,894,1916,
10,881892,861.2226563,1724,1574,3298,
10,896256,875.25,1209,1029,2238,
10,910628,889.2851563,1620,1423,3043,
10,925000,903.3203125,1784,1541,3325,
10,939380,917.3632813,1171,1041,2212,
10,953748,931.3945313,1901,1737,3638,
10,968118,945.4277344,1562,1175,2737,
10,982498,959.4707031,2019,1840,3859,
10,996880,973.515625,2250,2114,4364,
10,1011268,987.5664063,1994,1747,3741,
10,1025636,1001.597656,2258,1952,4210,
10,1040008,1015.632813,2151,1902,4053,
10,1054390,1029.677734,2288,2106,4394,
10,1068772,1043.722656,2461,2271,4732,
10,1083160,1057.773438,2325,2081,4406,
10,1097548,1071.824219,2238,1911,4149,
10,1111922,1085.861328,1993,1800,3793,
10,1126302,1099.904297,2016,1866,3882,
10,1140682,1113.947266,2086,1875,3961,
10,1155066,1127.994141,2065,1896,3961,
10,1169430,1142.021484,2165,1869,4034,
10,1183806,1156.060547,2113,1909,4022,
10,1198186,1170.103516,2300,2100,4400,
10,1212570,1184.150391,2073,1771,3844,
10,1226956,1198.199219,2120,1951,4071,BAn20m5 (iteration 1)
10,15162,14.80664063,147,91,238,
10,29536,28.84375,173,118,291,
10,43908,42.87890625,126,80,206,
10,58280,56.9140625,121,75,196,
10,72668,70.96484375,145,88,233,
10,87046,85.00585938,149,96,245,
10,101412,99.03515625,131,100,231,
10,115786,113.0722656,127,87,214,
10,130158,127.1074219,128,82,210,
10,145230,141.8261719,144,77,221,
10,160322,156.5644531,4321,4255,8576,
10,175412,171.3007813,154,101,255,
10,190490,186.0253906,142,86,228,
10,205552,200.734375,351,290,641,
10,220622,215.4511719,572,500,1072,
10,235000,229.4921875,161,97,258,
10,249382,243.5371094,625,554,1179,
10,263756,257.5742188,185,113,298,
10,278146,271.6269531,193,108,301,
10,292514,285.6582031,200,117,317,
10,306886,299.6933594,178,101,279,
10,321268,313.7382813,570,476,1046,
10,335650,327.7832031,1410,1317,2727,
10,350014,341.8105469,730,642,1372,
10,364410,355.8691406,615,520,1135,
10,378774,369.8964844,830,745,1575,
10,393140,383.9257813,957,886,1843,
10,407506,397.9550781,887,789,1676,
10,421874,411.9863281,542,407,949,
10,436240,426.015625,1014,887,1901,
10,450628,440.0664063,533,442,975,
10,465006,454.1074219,1274,1154,2428,
10,479384,468.1484375,991,853,1844,
10,493772,482.1992188,920,799,1719,
10,508154,496.2441406,641,547,1188,
10,522532,510.2851563,1218,1116,2334,
10,536904,524.3203125,956,863,1819,
10,551274,538.3535156,1585,1469,3054,
10,565654,552.3964844,648,521,1169,
10,580034,566.4394531,967,863,1830,
10,594396,580.4648438,1123,952,2075,
10,608784,594.515625,1005,837,1842,
10,623162,608.5566406,1060,910,1970,
10,637528,622.5859375,1005,887,1892,
10,651904,636.625,2149,2033,4182,
10,666272,650.65625,1847,1729,3576,
10,680654,664.7011719,1564,1332,2896,
10,695026,678.7363281,1512,1377,2889,
10,709412,692.7851563,1524,1410,2934,
10,723790,706.8261719,1581,1464,3045,
10,738156,720.8554688,1613,1487,3100,
10,752526,734.8886719,1317,1186,2503,
10,766906,748.9316406,2094,1889,3983,
10,781278,762.9667969,1320,1187,2507,
10,795654,777.0058594,1859,1742,3601,
10,810032,791.046875,1473,1319,2792,
10,824402,805.0800781,1747,1498,3245,
10,838788,819.1289063,1977,1776,3753,
10,853168,833.171875,1573,1395,2968,
10,867546,847.2128906,2038,1858,3896,
10,881920,861.25,1449,1290,2739,
10,896298,875.2910156,1489,1313,2802,
10,910668,889.3242188,1608,1473,3081,
10,925044,903.3632813,1665,1512,3177,
10,939408,917.390625,1053,918,1971,
10,953782,931.4277344,1458,1275,2733,
10,968150,945.4589844,1808,1625,3433,
10,982508,959.4804688,1746,1595,3341,
10,996900,973.5351563,2338,2179,4517,
10,1011276,987.5742188,2282,2148,4430,
10,1025654,1001.615234,2194,1908,4102,
10,1040044,1015.667969,2218,1933,4151,
10,1054412,1029.699219,2207,2025,4232,
10,1068776,1043.726563,2310,2084,4394,
10,1083144,1057.757813,2283,2058,4341,
10,1097528,1071.804688,2130,1947,4077,
10,1111900,1085.839844,2067,1779,3846,
10,1126270,1099.873047,2103,1953,4056,
10,1140648,1113.914063,2282,2115,4397,
10,1155012,1127.941406,2106,1939,4045,
10,1169380,1141.972656,2291,2098,4389,
10,1183754,1156.009766,2101,1893,3994,
10,1198114,1170.033203,2319,2160,4479,
10,1212488,1184.070313,2239,2068,4307,
10,1226864,1198.109375,2198,2022,4220,BAn20m5 (iteration 2)
10,15168,14.8125,131,89,220,
10,29560,28.8671875,183,143,326,
10,43930,42.90039063,138,84,222,
10,58302,56.93554688,112,71,183,
10,72694,70.99023438,147,89,236,
10,87098,85.05664063,214,112,326,
10,101496,99.1171875,220,164,384,
10,115874,113.1582031,125,80,205,
10,130256,127.203125,136,88,224,
10,145316,141.9101563,155,85,240,
10,160386,156.6269531,4791,4725,9516,
10,175466,171.3535156,189,121,310,
10,190530,186.0644531,145,87,232,
10,205600,200.78125,153,93,246,
10,220686,215.5136719,918,841,1759,
10,235056,229.546875,180,79,259,
10,249436,243.5898438,215,120,335,
10,263818,257.6347656,207,97,304,
10,278204,271.6835938,201,98,299,
10,292594,285.7363281,171,103,274,
10,306962,299.7675781,903,771,1674,
10,321330,313.7988281,394,322,716,
10,335704,327.8359375,779,698,1477,
10,350082,341.8769531,879,794,1673,
10,364476,355.9335938,694,618,1312,
10,378852,369.9726563,772,697,1469,
10,393234,384.0175781,637,539,1176,
10,407616,398.0625,796,725,1521,
10,421982,412.0917969,427,330,757,
10,436362,426.1347656,1041,964,2005,
10,450726,440.1621094,807,704,1511,
10,465106,454.2050781,841,758,1599,
10,479494,468.2558594,1009,922,1931,
10,493874,482.2988281,875,790,1665,
10,508244,496.3320313,611,496,1107,
10,522612,510.3632813,1447,1355,2802,
10,536986,524.4003906,762,668,1430,
10,551364,538.4414063,828,727,1555,
10,565742,552.4824219,852,755,1607,
10,580110,566.5136719,679,589,1268,
10,594484,580.5507813,1015,896,1911,
10,608856,594.5859375,986,886,1872,
10,623240,608.6328125,1032,913,1945,
10,637614,622.6699219,737,621,1358,
10,651994,636.7128906,2271,2141,4412,
10,666366,650.7480469,1676,1560,3236,
10,680744,664.7890625,1377,1254,2631,
10,695110,678.8183594,2045,1915,3960,
10,709486,692.8574219,1339,1219,2558,
10,723858,706.8925781,1600,1496,3096,
10,738230,720.9277344,1411,1300,2711,
10,752588,734.9492188,1309,1171,2480,
10,766974,748.9980469,1788,1669,3457,
10,781338,763.0253906,1424,1296,2720,
10,795718,777.0683594,1477,1355,2832,
10,810096,791.109375,1571,1437,3008,
10,824468,805.1445313,1905,1775,3680,
10,838844,819.1835938,1529,1373,2902,
10,853216,833.21875,1666,1517,3183,
10,867590,847.2558594,1847,1712,3559,
10,881968,861.296875,1389,1243,2632,
10,896338,875.3300781,2102,1925,4027,
10,910730,889.3847656,1504,1350,2854,
10,925112,903.4296875,2309,2175,4484,
10,939488,917.46875,1486,1340,2826,
10,953870,931.5136719,1807,1600,3407,
10,968228,945.5351563,2280,2034,4314,
10,982590,959.5605469,2286,1968,4254,
10,996968,973.6015625,2513,2332,4845,
10,1011338,987.6347656,2371,2134,4505,
10,1025702,1001.662109,2247,2034,4281,
10,1040082,1015.705078,2449,2280,4729,
10,1054460,1029.746094,2445,2271,4716,
10,1068838,1043.787109,2610,2432,5042,
10,1083210,1057.822266,2581,2407,4988,
10,1097606,1071.880859,2219,2022,4241,
10,1111978,1085.916016,2155,1969,4124,
10,1126332,1099.933594,2173,1978,4151,
10,1140700,1113.964844,2597,2374,4971,
10,1155074,1128.001953,2441,2237,4678,
10,1169448,1142.039063,2306,2076,4382,
10,1183836,1156.089844,2371,2186,4557,
10,1198218,1170.134766,2407,2226,4633,
10,1212594,1184.173828,2317,2119,4436,
10,1226960,1198.203125,2915,2733,5648,BAn20m5 (iteration 3)
10,15168,14.8125,161,106,267,
10,29542,28.84960938,219,163,382,
10,43922,42.89257813,131,90,221,
10,58308,56.94140625,123,80,203,
10,72680,70.9765625,112,75,187,
10,87062,85.02148438,140,103,243,
10,101432,99.0546875,149,115,264,
10,115812,113.0976563,139,106,245,
10,130194,127.1425781,173,112,285,
10,145278,141.8730469,180,110,290,
10,160354,156.5957031,4715,4654,9369,
10,175408,171.296875,188,115,303,
10,190490,186.0253906,175,113,288,
10,205568,200.75,906,840,1746,
10,220648,215.4765625,644,571,1215,
10,235024,229.515625,192,128,320,
10,249402,243.5566406,200,111,311,
10,263770,257.5878906,142,81,223,
10,278154,271.6347656,147,91,238,
10,292542,285.6855469,182,104,286,
10,306916,299.7226563,465,386,851,
10,321302,313.7714844,599,523,1122,
10,335686,327.8183594,781,715,1496,
10,350062,341.8574219,763,689,1452,
10,364454,355.9121094,607,519,1126,
10,378822,369.9433594,717,640,1357,
10,393184,383.96875,902,793,1695,
10,407558,398.0058594,920,822,1742,
10,421928,412.0390625,777,639,1416,
10,436298,426.0722656,799,675,1474,
10,450680,440.1171875,912,788,1700,
10,465050,454.1503906,392,276,668,
10,479444,468.2070313,598,471,1069,
10,493808,482.234375,629,469,1098,
10,508194,496.2832031,1077,986,2063,
10,522566,510.3183594,599,506,1105,
10,536942,524.3574219,936,824,1760,
10,551304,538.3828125,926,835,1761,
10,565680,552.421875,611,513,1124,
10,580050,566.4550781,1021,917,1938,
10,594414,580.4824219,965,862,1827,
10,608800,594.53125,993,888,1881,
10,623174,608.5683594,1162,1043,2205,
10,637552,622.609375,1050,915,1965,
10,651926,636.6464844,2057,1954,4011,
10,666292,650.6757813,1369,1255,2624,
10,680670,664.7167969,1434,1329,2763,
10,695046,678.7558594,1691,1587,3278,
10,709416,692.7890625,1529,1421,2950,
10,723784,706.8203125,1243,1133,2376,
10,738164,720.8632813,1505,1359,2864,
10,752552,734.9140625,1810,1576,3386,
10,766926,748.9511719,1522,1335,2857,
10,781304,762.9921875,1382,1227,2609,
10,795676,777.0273438,1736,1602,3338,
10,810044,791.0585938,1841,1628,3469,
10,824420,805.0976563,1344,1208,2552,
10,838792,819.1328125,1762,1625,3387,
10,853156,833.1601563,1369,1234,2603,
10,867522,847.1894531,1726,1582,3308,
10,881894,861.2246094,1913,1762,3675,
10,896282,875.2753906,1542,1412,2954,
10,910654,889.3105469,1632,1507,3139,
10,925036,903.3554688,1606,1488,3094,
10,939418,917.4003906,1476,1297,2773,
10,953794,931.4394531,1788,1635,3423,
10,968166,945.4746094,1683,1525,3208,
10,982548,959.5195313,2136,1977,4113,
10,996916,973.5507813,2317,2160,4477,
10,1011290,987.5878906,2292,2129,4421,
10,1025676,1001.636719,2322,2151,4473,
10,1040060,1015.683594,2444,2289,4733,
10,1054438,1029.724609,2467,2296,4763,
10,1068828,1043.777344,2484,2291,4775,
10,1083198,1057.810547,2383,2213,4596,
10,1097584,1071.859375,2135,1947,4082,
10,1111964,1085.902344,2191,2023,4214,
10,1126350,1099.951172,2064,1905,3969,
10,1140742,1114.005859,2269,2069,4338,
10,1155124,1128.050781,2167,2002,4169,
10,1169510,1142.099609,2239,2057,4296,
10,1183898,1156.150391,2453,2232,4685,
10,1198270,1170.185547,2175,2020,4195,
10,1212640,1184.21875,2263,2074,4337,
10,1227008,1198.25,2301,2121,4422,BAn20m5 (iteration 4)
10,15184,14.828125,141,106,247,
10,29552,28.859375,136,92,228,
10,43932,42.90234375,118,78,196,
10,58304,56.9375,141,100,241,
10,72682,70.97851563,125,81,206,
10,87050,85.00976563,150,99,249,
10,101422,99.04492188,149,86,235,
10,115800,113.0859375,175,127,302,
10,130186,127.1347656,191,126,317,
10,145266,141.8613281,186,118,304,
10,160342,156.5839844,2771,2710,5481,
10,175414,171.3027344,605,553,1158,
10,190480,186.015625,239,182,421,
10,205552,200.734375,212,141,353,
10,220622,215.4511719,710,655,1365,
10,234990,229.4824219,158,96,254,
10,249362,243.5175781,187,111,298,
10,263742,257.5605469,232,144,376,
10,278116,271.5976563,222,134,356,
10,292492,285.6367188,162,90,252,
10,306878,299.6855469,173,97,270,
10,321254,313.7246094,1782,1718,3500,
10,335626,327.7597656,628,560,1188,
10,349996,341.7929688,897,832,1729,
10,364384,355.84375,629,555,1184,
10,378748,369.8710938,933,860,1793,
10,393126,383.9121094,884,810,1694,
10,407502,397.9511719,955,874,1829,
10,421874,411.9863281,661,560,1221,
10,436250,426.0253906,929,853,1782,
10,450632,440.0703125,323,224,547,
10,465008,454.109375,759,676,1435,
10,479376,468.140625,983,892,1875,
10,493762,482.1894531,1042,960,2002,
10,508128,496.21875,836,747,1583,
10,522500,510.2539063,630,532,1162,
10,536884,524.3007813,917,817,1734,
10,551262,538.3417969,905,806,1711,
10,565624,552.3671875,633,536,1169,
10,579992,566.3984375,1034,940,1974,
10,594358,580.4277344,1013,914,1927,
10,608724,594.4570313,968,865,1833,
10,623100,608.4960938,987,872,1859,
10,637476,622.5351563,662,545,1207,
10,651848,636.5703125,2253,2124,4377,
10,666222,650.6074219,1572,1457,3029,
10,680590,664.6386719,1409,1299,2708,
10,694972,678.6835938,1727,1593,3320,
10,709362,692.7363281,1514,1395,2909,
10,723728,706.765625,1273,1159,2432,
10,738112,720.8125,1644,1528,3172,
10,752488,734.8515625,1631,1511,3142,
10,766886,748.9121094,1654,1535,3189,
10,781270,762.9589844,1872,1733,3605,
10,795636,776.9882813,1645,1508,3153,
10,810008,791.0234375,1488,1328,2816,
10,824390,805.0683594,1747,1603,3350,
10,838760,819.1015625,1549,1377,2926,
10,853142,833.1464844,1932,1784,3716,
10,867512,847.1796875,1414,1291,2705,
10,881882,861.2128906,2053,1887,3940,
10,896270,875.2636719,1453,1303,2756,
10,910664,889.3203125,2079,1938,4017,
10,925044,903.3632813,1735,1592,3327,
10,939416,917.3984375,1471,1345,2816,
10,953796,931.4414063,1655,1514,3169,
10,968180,945.4882813,2075,1911,3986,
10,982568,959.5390625,2144,1948,4092,
10,996950,973.5839844,2301,2017,4318,
10,1011316,987.6132813,2429,2194,4623,
10,1025696,1001.65625,2354,2184,4538,
10,1040082,1015.705078,2290,2141,4431,
10,1054462,1029.748047,2298,2122,4420,
10,1068838,1043.787109,2344,2139,4483,
10,1083220,1057.832031,2363,2227,4590,
10,1097594,1071.869141,2125,1931,4056,
10,1111972,1085.910156,1905,1743,3648,
10,1126352,1099.953125,2008,1855,3863,
10,1140724,1113.988281,1934,1777,3711,
10,1155086,1128.013672,2209,2060,4269,
10,1169466,1142.056641,2056,1855,3911,
10,1183850,1156.103516,1963,1770,3733,
10,1198240,1170.15625,2089,1934,4023,
10,1212622,1184.201172,2031,1841,3872,
10,1226988,1198.230469,1978,1818,3796,BAn20m5 (iteration 5)
10,15178,14.82226563,111,70,181,
10,29548,28.85546875,135,85,220,
10,43922,42.89257813,111,75,186,
10,58298,56.93164063,117,79,196,
10,72678,70.97460938,131,82,213,
10,87064,85.0234375,131,89,220,
10,101448,99.0703125,118,74,192,
10,115824,113.109375,133,97,230,
10,130206,127.1542969,147,108,255,
10,144592,141.203125,137,81,218,
10,158972,155.2460938,149,99,248,
10,173348,169.2851563,134,81,215,
10,187736,183.3359375,2103,2044,4147,
10,202820,198.0664063,1512,1430,2942,
10,217894,212.7871094,870,815,1685,
10,232966,227.5058594,180,114,294,
10,248048,242.234375,162,94,256,
10,263122,256.9550781,164,102,266,
10,278196,271.6757813,1408,1338,2746,
10,293268,286.3945313,1152,1084,2236,
10,308332,301.1054688,519,426,945,
10,323400,315.8203125,492,418,910,
10,338480,330.546875,476,385,861,
10,353554,345.2675781,722,647,1369,
10,368642,360.0019531,727,639,1366,
10,383714,374.7207031,317,235,552,
10,398802,389.4550781,586,513,1099,
10,413890,404.1894531,1413,1328,2741,
10,428256,418.21875,566,483,1049,
10,442618,432.2441406,590,505,1095,
10,456996,446.2851563,653,552,1205,
10,471368,460.3203125,950,867,1817,
10,485748,474.3632813,876,797,1673,
10,500116,488.3945313,557,465,1022,
10,514488,502.4296875,996,905,1901,
10,528870,516.4746094,946,855,1801,
10,543238,530.5058594,968,853,1821,
10,557614,544.5449219,1027,925,1952,
10,571996,558.5898438,737,637,1374,
10,586364,572.6210938,1083,981,2064,
10,600738,586.6582031,1160,1033,2193,
10,615132,600.7148438,654,550,1204,
10,629500,614.7460938,988,878,1866,
10,643868,628.7773438,1125,998,2123,
10,658246,642.8183594,2039,1902,3941,
10,672630,656.8652344,1726,1623,3349,
10,687002,670.9003906,1602,1484,3086,
10,701376,684.9375,1445,1334,2779,
10,715748,698.9726563,1522,1391,2913,
10,730116,713.0039063,1731,1611,3342,
10,744482,727.0332031,1268,1146,2414,
10,758864,741.078125,1844,1726,3570,
10,773244,755.1210938,1607,1488,3095,
10,787624,769.1640625,1493,1383,2876,
10,802008,783.2109375,1330,1210,2540,
10,816380,797.2460938,1681,1570,3251,
10,830752,811.28125,1259,1131,2390,
10,845132,825.3242188,1558,1417,2975,
10,859508,839.3632813,1736,1577,3313,
10,873896,853.4140625,1801,1674,3475,
10,888284,867.4648438,1615,1491,3106,
10,902660,881.5039063,1690,1533,3223,
10,917048,895.5546875,1643,1510,3153,
10,931430,909.5996094,1783,1630,3413,
10,945796,923.6289063,1410,1249,2659,
10,960178,937.6738281,2011,1847,3858,
10,974570,951.7285156,1909,1643,3552,
10,988946,965.7675781,2519,2241,4760,
10,1003328,979.8125,2425,2263,4688,
10,1017706,993.8535156,2403,2244,4647,
10,1032100,1007.910156,2609,2375,4984,
10,1046468,1021.941406,2501,2329,4830,
10,1060848,1035.984375,2477,2318,4795,
10,1075228,1050.027344,2462,2298,4760,
10,1089592,1064.054688,2384,2221,4605,
10,1103972,1078.097656,2455,2299,4754,
10,1118354,1092.142578,2496,2318,4814,
10,1132744,1106.195313,2514,2328,4842,
10,1147128,1120.242188,2524,2371,4895,
10,1161498,1134.275391,2599,2438,5037,
10,1175874,1148.314453,2453,2251,4704,
10,1190264,1162.367188,2530,2354,4884,
10,1204642,1176.408203,2470,2243,4713,
10,1219010,1190.439453,2529,2339,4868,
10,1233394,1204.486328,2597,2398,4995,
10,1247780,1218.535156,2557,2354,4911,
10,1262154,1232.572266,2722,2492,5214,
10,1276544,1246.625,2557,2335,4892,
10,1290926,1260.669922,3101,2880,5981,
10,1305304,1274.710938,2842,2632,5474,
10,1319690,1288.759766,3310,3079,6389,
10,1334072,1302.804688,3498,3262,6760,
10,1348444,1316.839844,3515,3293,6808,
10,1362822,1330.880859,3592,3374,6966,
10,1377204,1344.925781,3533,3347,6880,
10,1391578,1358.962891,3419,3206,6625,
10,1405964,1373.011719,3510,3309,6819,
10,1420336,1387.046875,3627,3410,7037,
10,1434720,1401.09375,3065,2819,5884,
10,1449108,1415.144531,3307,3079,6386,
10,1463488,1429.1875,3160,2925,6085,
10,1477870,1443.232422,3207,2972,6179,
10,1492260,1457.285156,3233,3020,6253,
10,1506634,1471.322266,3121,2907,6028,
10,1521006,1485.357422,3101,2876,5977,
10,1535394,1499.408203,3247,2985,6232,
10,1549770,1513.447266,3145,2912,6057,
10,1564144,1527.484375,3382,3148,6530,
10,1578536,1541.539063,3142,2906,6048,
10,1592920,1555.585938,3296,3064,6360,
10,1607316,1569.644531,3277,3031,6308,
10,1621706,1583.697266,3226,2961,6187,BAn20m7 (iteration 1)
10,15170,14.81445313,140,98,238,
10,29548,28.85546875,157,92,249,
10,43920,42.890625,162,114,276,
10,58302,56.93554688,134,88,222,
10,72662,70.95898438,163,105,268,
10,87048,85.0078125,145,90,235,
10,101436,99.05859375,138,89,227,
10,115820,113.1054688,173,113,286,
10,130206,127.1542969,172,79,251,
10,144576,141.1875,140,85,225,
10,158952,155.2265625,145,86,231,
10,173324,169.2617188,163,99,262,
10,187692,183.2929688,786,721,1507,
10,202768,198.015625,4675,4614,9289,
10,217864,212.7578125,192,114,306,
10,232954,227.4941406,1492,1414,2906,
10,248034,242.2207031,202,125,327,
10,263104,256.9375,340,283,623,
10,278186,271.6660156,778,713,1491,
10,293284,286.4101563,919,856,1775,
10,308360,301.1328125,481,389,870,
10,323432,315.8515625,445,360,805,
10,338514,330.5800781,588,502,1090,
10,353588,345.3007813,650,577,1227,
10,368674,360.0332031,918,855,1773,
10,383738,374.7441406,208,119,327,
10,398826,389.4785156,708,623,1331,
10,413898,404.1972656,1294,1205,2499,
10,428260,418.2226563,206,121,327,
10,442622,432.2480469,949,872,1821,
10,456996,446.2851563,613,502,1115,
10,471378,460.3300781,720,625,1345,
10,485758,474.3730469,765,679,1444,
10,500140,488.4179688,986,907,1893,
10,514502,502.4433594,1029,924,1953,
10,528880,516.484375,1585,1501,3086,
10,543256,530.5234375,740,610,1350,
10,557628,544.5585938,501,331,832,
10,572012,558.6054688,1166,1027,2193,
10,586390,572.6464844,1124,1033,2157,
10,600778,586.6972656,624,519,1143,
10,615160,600.7421875,1093,997,2090,
10,629534,614.7792969,1155,1039,2194,
10,643898,628.8066406,1112,1001,2113,
10,658282,642.8535156,2467,2354,4821,
10,672656,656.890625,1567,1443,3010,
10,687042,670.9394531,1589,1473,3062,
10,701420,684.9804688,1851,1740,3591,
10,715802,699.0253906,1631,1514,3145,
10,730172,713.0585938,1387,1267,2654,
10,744550,727.0996094,1729,1603,3332,
10,758942,741.1542969,1587,1446,3033,
10,773324,755.1992188,1602,1478,3080,
10,787712,769.25,1637,1529,3166,
10,802094,783.2949219,1895,1788,3683,
10,816456,797.3203125,1734,1612,3346,
10,830824,811.3515625,1785,1653,3438,
10,845208,825.3984375,1731,1600,3331,
10,859580,839.4335938,1561,1406,2967,
10,873950,853.4667969,2059,1933,3992,
10,888322,867.5019531,1917,1775,3692,
10,902700,881.5429688,1508,1378,2886,
10,917062,895.5683594,1790,1662,3452,
10,931436,909.6054688,2024,1871,3895,
10,945820,923.6523438,1485,1315,2800,
10,960200,937.6953125,2169,2011,4180,
10,974584,951.7421875,1744,1570,3314,
10,988956,965.7773438,2581,2415,4996,
10,1003336,979.8203125,2447,2287,4734,
10,1017704,993.8515625,2518,2358,4876,
10,1032088,1007.898438,2486,2255,4741,
10,1046472,1021.945313,2442,2277,4719,
10,1060840,1035.976563,2613,2421,5034,
10,1075226,1050.025391,2539,2372,4911,
10,1089594,1064.056641,2566,2382,4948,
10,1103976,1078.101563,2587,2437,5024,
10,1118360,1092.148438,2687,2506,5193,
10,1132728,1106.179688,2436,2231,4667,
10,1147106,1120.220703,2492,2335,4827,
10,1161484,1134.261719,2477,2309,4786,
10,1175854,1148.294922,2578,2391,4969,
10,1190218,1162.322266,2483,2278,4761,
10,1204604,1176.371094,2553,2356,4909,
10,1218970,1190.400391,2720,2499,5219,
10,1233340,1204.433594,2605,2389,4994,
10,1247716,1218.472656,2632,2384,5016,
10,1262100,1232.519531,2634,2416,5050,
10,1276478,1246.560547,2585,2362,4947,
10,1290864,1260.609375,2701,2506,5207,
10,1305234,1274.642578,2709,2500,5209,
10,1319604,1288.675781,3339,3120,6459,
10,1333992,1302.726563,3467,3248,6715,
10,1348370,1316.767578,3593,3348,6941,
10,1362746,1330.806641,3465,3275,6740,
10,1377122,1344.845703,3544,3343,6887,
10,1391506,1358.892578,3564,3339,6903,
10,1405880,1372.929688,3512,3299,6811,
10,1420246,1386.958984,3642,3420,7062,
10,1434638,1401.013672,3139,2890,6029,
10,1449008,1415.046875,3255,3024,6279,
10,1463376,1429.078125,3147,2894,6041,
10,1477768,1443.132813,3250,3007,6257,
10,1492144,1457.171875,4071,3840,7911,
10,1506510,1471.201172,3362,3060,6422,
10,1520888,1485.242188,3316,3077,6393,
10,1535266,1499.283203,3672,3285,6957,
10,1549650,1513.330078,3371,2878,6249,
10,1564038,1527.380859,3436,3171,6607,
10,1578426,1541.431641,3269,2992,6261,
10,1592810,1555.478516,3253,3009,6262,
10,1607180,1569.511719,3277,3019,6296,
10,1621556,1583.550781,3355,3073,6428,BAn20m7 (iteration 2)
10,15170,14.81445313,147,97,244,
10,29556,28.86328125,170,112,282,
10,43938,42.90820313,170,85,255,
10,58330,56.96289063,138,83,221,
10,72694,70.99023438,152,87,239,
10,87054,85.01367188,174,99,273,
10,101422,99.04492188,172,95,267,
10,115788,113.0742188,189,124,313,
10,130152,127.1015625,206,109,315,
10,144528,141.140625,224,105,329,
10,158908,155.1835938,218,122,340,
10,173272,169.2109375,193,77,270,
10,187650,183.2519531,2406,2282,4688,
10,202720,197.96875,2111,2015,4126,
10,217800,212.6953125,830,765,1595,
10,232872,227.4140625,153,85,238,
10,247950,242.1386719,177,93,270,
10,263034,256.8691406,172,103,275,
10,278104,271.5859375,841,751,1592,
10,293180,286.3085938,771,587,1358,
10,308266,301.0410156,697,459,1156,
10,323356,315.7773438,444,359,803,
10,338436,330.5039063,508,439,947,
10,353524,345.2382813,710,637,1347,
10,368584,359.9453125,861,767,1628,
10,383676,374.6835938,1015,921,1936,
10,398756,389.4101563,451,348,799,
10,413836,404.1367188,1256,1124,2380,
10,428210,418.1738281,267,186,453,
10,442588,432.2148438,866,777,1643,
10,456972,446.2617188,886,726,1612,
10,471362,460.3144531,918,822,1740,
10,485740,474.3554688,994,898,1892,
10,500110,488.3886719,933,848,1781,
10,514494,502.4355469,519,426,945,
10,528864,516.46875,2121,2030,4151,
10,543244,530.5117188,254,168,422,
10,557628,544.5585938,1111,1008,2119,
10,571992,558.5859375,1135,1029,2164,
10,586350,572.6074219,606,508,1114,
10,600730,586.6503906,1087,976,2063,
10,615094,600.6777344,1107,1001,2108,
10,629462,614.7089844,668,557,1225,
10,643850,628.7597656,1170,1030,2200,
10,658218,642.7910156,1882,1760,3642,
10,672602,656.8378906,1544,1440,2984,
10,686976,670.875,1775,1671,3446,
10,701344,684.90625,1613,1502,3115,
10,715722,698.9472656,1295,1190,2485,
10,730086,712.9746094,1991,1871,3862,
10,744460,727.0117188,1821,1696,3517,
10,758838,741.0527344,1832,1691,3523,
10,773220,755.0976563,2023,1891,3914,
10,787604,769.1445313,1520,1394,2914,
10,801966,783.1699219,2008,1840,3848,
10,816332,797.1992188,1885,1748,3633,
10,830722,811.2519531,1724,1569,3293,
10,845094,825.2871094,1768,1634,3402,
10,859468,839.3242188,1978,1845,3823,
10,873834,853.3535156,1836,1703,3539,
10,888224,867.40625,1482,1362,2844,
10,902610,881.4550781,2165,2034,4199,
10,916984,895.4921875,1775,1647,3422,
10,931382,909.5527344,1953,1801,3754,
10,945762,923.5957031,1643,1471,3114,
10,960132,937.6289063,2450,2174,4624,
10,974498,951.6582031,2134,1842,3976,
10,988876,965.6992188,2948,2745,5693,
10,1003256,979.7421875,2652,2481,5133,
10,1017628,993.7773438,2415,2231,4646,
10,1032000,1007.8125,2562,2376,4938,
10,1046378,1021.853516,2892,2685,5577,
10,1060740,1035.878906,2745,2550,5295,
10,1075126,1049.927734,2601,2398,4999,
10,1089500,1063.964844,2706,2536,5242,
10,1103868,1077.996094,2535,2370,4905,
10,1118260,1092.050781,2618,2449,5067,
10,1132644,1106.097656,2543,2244,4787,
10,1147036,1120.152344,2725,2474,5199,
10,1161420,1134.199219,2782,2423,5205,
10,1175812,1148.253906,2699,2518,5217,
10,1190194,1162.298828,2634,2427,5061,
10,1204574,1176.341797,2692,2508,5200,
10,1218948,1190.378906,2635,2463,5098,
10,1233316,1204.410156,2605,2397,5002,
10,1247698,1218.455078,3025,2818,5843,
10,1262076,1232.496094,3160,2896,6056,
10,1276454,1246.537109,3690,3428,7118,
10,1290838,1260.583984,2872,2664,5536,
10,1305222,1274.630859,2695,2502,5197,
10,1319592,1288.664063,3002,2805,5807,
10,1333964,1302.699219,3678,3447,7125,
10,1348332,1316.730469,3593,3368,6961,
10,1362692,1330.753906,3438,3241,6679,
10,1377062,1344.787109,3595,3383,6978,
10,1391440,1358.828125,3545,3342,6887,
10,1405816,1372.867188,3530,3333,6863,
10,1420214,1386.927734,3619,3397,7016,
10,1434566,1400.943359,3284,3019,6303,
10,1448928,1414.96875,3239,3028,6267,
10,1463308,1429.011719,3348,3142,6490,
10,1477680,1443.046875,3218,2981,6199,
10,1492062,1457.091797,3230,2985,6215,
10,1506436,1471.128906,3288,3045,6333,
10,1520816,1485.171875,3223,2984,6207,
10,1535196,1499.214844,3323,2897,6220,
10,1549562,1513.244141,3289,3043,6332,
10,1563946,1527.291016,3369,3057,6426,
10,1578324,1541.332031,3349,3093,6442,
10,1592698,1555.369141,3520,3285,6805,
10,1607080,1569.414063,3276,3016,6292,
10,1621448,1583.445313,3291,3051,6342,BAn20m7 (iteration 3)
10,15160,14.8046875,122,83,205,
10,29528,28.8359375,142,84,226,
10,43892,42.86328125,142,92,234,
10,58252,56.88671875,148,95,243,
10,72622,70.91992188,152,93,245,
10,87012,84.97265625,174,109,283,
10,101398,99.02148438,162,94,256,
10,115766,113.0527344,174,87,261,
10,130136,127.0859375,186,105,291,
10,144516,141.1289063,161,85,246,
10,158896,155.171875,185,96,281,
10,173286,169.2246094,220,120,340,
10,187660,183.2617188,1966,1872,3838,
10,202734,197.9824219,2645,2560,5205,
10,217812,212.7070313,594,492,1086,
10,232884,227.4257813,206,120,326,
10,247944,242.1328125,186,118,304,
10,263026,256.8613281,979,911,1890,
10,278100,271.5820313,593,430,1023,
10,293182,286.3105469,485,344,829,
10,308264,301.0390625,723,532,1255,
10,323330,315.7519531,600,419,1019,
10,338410,330.4785156,516,441,957,
10,353472,345.1875,635,555,1190,
10,368552,359.9140625,1018,941,1959,
10,383628,374.6367188,943,759,1702,
10,398700,389.3554688,565,458,1023,
10,413778,404.0800781,874,500,1374,
10,428158,418.1230469,331,237,568,
10,442524,432.1523438,1107,1012,2119,
10,456886,446.1777344,622,544,1166,
10,471262,460.2167969,1125,1023,2148,
10,485640,474.2578125,565,417,982,
10,500020,488.3007813,1291,1184,2475,
10,514390,502.3339844,726,630,1356,
10,528770,516.3769531,816,701,1517,
10,543154,530.4238281,1198,1069,2267,
10,557522,544.4550781,1220,1109,2329,
10,571898,558.4941406,1001,885,1886,
10,586284,572.5429688,880,777,1657,
10,600660,586.5820313,1196,1093,2289,
10,615048,600.6328125,1359,1239,2598,
10,629426,614.6738281,738,599,1337,
10,643804,628.7148438,1570,1467,3037,
10,658176,642.75,1462,1352,2814,
10,672558,656.7949219,1346,1245,2591,
10,686936,670.8359375,1598,1476,3074,
10,701324,684.8867188,1599,1486,3085,
10,715708,698.9335938,1628,1512,3140,
10,730088,712.9765625,1970,1828,3798,
10,744458,727.0097656,1521,1391,2912,
10,758836,741.0507813,2006,1869,3875,
10,773196,755.0742188,1840,1700,3540,
10,787578,769.1191406,1735,1621,3356,
10,801952,783.15625,1794,1672,3466,
10,816324,797.1914063,1585,1457,3042,
10,830708,811.2382813,1829,1694,3523,
10,845080,825.2734375,1873,1695,3568,
10,859446,839.3027344,2071,1949,4020,
10,873820,853.3398438,1745,1610,3355,
10,888188,867.3710938,1927,1792,3719,
10,902562,881.4082031,1922,1754,3676,
10,916936,895.4453125,1828,1700,3528,
10,931322,909.4941406,1802,1527,3329,
10,945698,923.5332031,2068,1908,3976,
10,960066,937.5644531,2175,1996,4171,
10,974452,951.6132813,2183,1993,4176,
10,988818,965.6425781,2166,1985,4151,
10,1003216,979.703125,2463,2299,4762,
10,1017590,993.7402344,2397,2230,4627,
10,1031964,1007.777344,2847,2653,5500,
10,1046352,1021.828125,2551,2374,4925,
10,1060716,1035.855469,3034,2866,5900,
10,1075086,1049.888672,2684,2496,5180,
10,1089478,1063.943359,2642,2484,5126,
10,1103864,1077.992188,2346,2153,4499,
10,1118238,1092.029297,2780,2623,5403,
10,1132610,1106.064453,2514,2300,4814,
10,1146982,1120.099609,2559,2386,4945,
10,1161364,1134.144531,2414,2230,4644,
10,1175742,1148.185547,2651,2480,5131,
10,1190120,1162.226563,2441,2275,4716,
10,1204504,1176.273438,2910,2723,5633,
10,1218866,1190.298828,2841,2664,5505,
10,1233234,1204.330078,2661,2436,5097,
10,1247604,1218.363281,2980,2748,5728,
10,1261986,1232.408203,2778,2557,5335,
10,1276362,1246.447266,2534,2322,4856,
10,1290742,1260.490234,2691,2503,5194,
10,1305124,1274.535156,2726,2532,5258,
10,1319504,1288.578125,3411,3218,6629,
10,1333876,1302.613281,4238,4003,8241,
10,1348252,1316.652344,4193,3907,8100,
10,1362630,1330.693359,3627,3390,7017,
10,1377012,1344.738281,3629,3420,7049,
10,1391396,1358.785156,3613,3370,6983,
10,1405782,1372.833984,3529,3297,6826,
10,1420144,1386.859375,3724,3486,7210,
10,1434526,1400.904297,3220,2574,5794,
10,1448884,1414.925781,3469,2520,5989,
10,1463256,1428.960938,3096,2840,5936,
10,1477630,1442.998047,2896,2677,5573,
10,1492004,1457.035156,3132,2888,6020,
10,1506378,1471.072266,3159,2938,6097,
10,1520764,1485.121094,3304,3040,6344,
10,1535142,1499.162109,3107,2845,5952,
10,1549520,1513.203125,2960,2739,5699,
10,1563890,1527.236328,3310,3076,6386,
10,1578280,1541.289063,3405,3146,6551,
10,1592658,1555.330078,3382,3122,6504,
10,1607050,1569.384766,3290,3032,6322,
10,1621416,1583.414063,3288,3033,6321,BAn20m7 (iteration 4)
10,15166,14.81054688,157,114,271,
10,29548,28.85546875,156,92,248,
10,43920,42.890625,169,90,259,
10,58294,56.92773438,135,82,217,
10,72662,70.95898438,141,92,233,
10,87040,85,143,95,238,
10,101408,99.03125,147,86,233,
10,115792,113.078125,144,78,222,
10,130176,127.125,164,97,261,
10,144556,141.1679688,150,70,220,
10,158924,155.1992188,161,83,244,
10,173306,169.2441406,195,104,299,
10,187690,183.2910156,810,708,1518,
10,202756,198.0039063,2304,2170,4474,
10,217840,212.734375,192,90,282,
10,232906,227.4472656,219,82,301,
10,247992,242.1796875,162,98,260,
10,263082,256.9160156,236,176,412,
10,278154,271.6347656,336,204,540,
10,293228,286.3554688,962,815,1777,
10,308302,301.0761719,527,414,941,
10,323390,315.8105469,517,423,940,
10,338452,330.5195313,483,410,893,
10,353542,345.2558594,632,563,1195,
10,368624,359.984375,745,669,1414,
10,383708,374.7148438,912,798,1710,
10,398780,389.4335938,495,220,715,
10,413850,404.1503906,897,674,1571,
10,428230,418.1933594,703,620,1323,
10,442604,432.2304688,383,300,683,
10,456998,446.2871094,696,609,1305,
10,471380,460.3320313,855,749,1604,
10,485770,474.3847656,499,410,909,
10,500140,488.4179688,909,830,1739,
10,514518,502.4589844,726,612,1338,
10,528892,516.4960938,894,735,1629,
10,543258,530.5253906,1793,1641,3434,
10,557632,544.5625,559,387,946,
10,572004,558.5976563,935,823,1758,
10,586374,572.6308594,1035,946,1981,
10,600750,586.6699219,1137,1048,2185,
10,615124,600.7070313,630,529,1159,
10,629510,614.7558594,1089,979,2068,
10,643884,628.7929688,1042,928,1970,
10,658252,642.8242188,1947,1826,3773,
10,672608,656.84375,1753,1650,3403,
10,686986,670.8847656,1483,1383,2866,
10,701374,684.9355469,1239,1126,2365,
10,715756,698.9804688,1649,1544,3193,
10,730128,713.015625,1470,1355,2825,
10,744508,727.0585938,1628,1489,3117,
10,758886,741.0996094,1888,1772,3660,
10,773272,755.1484375,1594,1474,3068,
10,787666,769.2050781,1689,1568,3257,
10,802038,783.2402344,1583,1465,3048,
10,816414,797.2792969,1668,1513,3181,
10,830794,811.3222656,1627,1492,3119,
10,845180,825.3710938,1382,1234,2616,
10,859558,839.4121094,2180,2017,4197,
10,873936,853.453125,1605,1472,3077,
10,888312,867.4921875,1908,1767,3675,
10,902696,881.5390625,1567,1436,3003,
10,917064,895.5703125,2022,1888,3910,
10,931428,909.5976563,1776,1421,3197,
10,945796,923.6289063,1810,1618,3428,
10,960170,937.6660156,1831,1656,3487,
10,974548,951.7070313,1470,1313,2783,
10,988914,965.7363281,2543,2350,4893,
10,1003288,979.7734375,2591,2422,5013,
10,1017662,993.8105469,2427,2263,4690,
10,1032032,1007.84375,2426,2261,4687,
10,1046422,1021.896484,2418,2239,4657,
10,1060798,1035.935547,2818,2634,5452,
10,1075162,1049.962891,3059,2897,5956,
10,1089550,1064.013672,2843,2687,5530,
10,1103918,1078.044922,2532,2375,4907,
10,1118290,1092.080078,2781,2590,5371,
10,1132680,1106.132813,2683,2448,5131,
10,1147058,1120.173828,2838,2676,5514,
10,1161446,1134.224609,2632,2469,5101,
10,1175830,1148.271484,2539,2375,4914,
10,1190206,1162.310547,2424,2258,4682,
10,1204574,1176.341797,2694,2523,5217,
10,1218950,1190.380859,2706,2536,5242,
10,1233324,1204.417969,2411,2219,4630,
10,1247690,1218.447266,2588,2387,4975,
10,1262068,1232.488281,2915,2706,5621,
10,1276438,1246.521484,2511,2318,4829,
10,1290820,1260.566406,2497,2311,4808,
10,1305208,1274.617188,2735,2533,5268,
10,1319592,1288.664063,3027,2840,5867,
10,1333970,1302.705078,3549,3319,6868,
10,1348348,1316.746094,3435,3226,6661,
10,1362732,1330.792969,3399,3192,6591,
10,1377108,1344.832031,3484,3293,6777,
10,1391480,1358.867188,3953,3718,7671,
10,1405850,1372.900391,3482,3270,6752,
10,1420222,1386.935547,3914,3708,7622,
10,1434596,1400.972656,3003,2769,5772,
10,1448968,1415.007813,2932,2714,5646,
10,1463344,1429.046875,3058,2853,5911,
10,1477716,1443.082031,3087,2883,5970,
10,1492088,1457.117188,3535,3321,6856,
10,1506454,1471.146484,3148,2941,6089,
10,1520842,1485.197266,2988,2736,5724,
10,1535212,1499.230469,3103,2853,5956,
10,1549592,1513.273438,3189,2970,6159,
10,1563982,1527.326172,3176,2950,6126,
10,1578350,1541.357422,3161,2932,6093,
10,1592720,1555.390625,3153,2902,6055,
10,1607090,1569.423828,3623,3375,6998,
10,1621468,1583.464844,3095,2851,5946,BAn20m7 (iteration 5)
10,15172,14.81640625,148,104,252,
10,29558,28.86523438,169,103,272,
10,43928,42.8984375,153,104,257,
10,58306,56.93945313,163,95,258,
10,72688,70.984375,166,93,259,
10,87056,85.015625,153,88,241,
10,101424,99.046875,153,91,244,
10,115806,113.0917969,153,76,229,
10,130180,127.1289063,168,87,255,
10,144564,141.1757813,131,83,214,
10,158948,155.2226563,169,75,244,
10,173330,169.2675781,168,81,249,
10,187698,183.2988281,303,74,377,
10,202078,197.3417969,311,149,460,
10,216460,211.3867188,2280,2106,4386,
10,230830,225.4199219,304,104,408,
10,245200,239.453125,262,83,345,
10,259578,253.4941406,264,83,347,
10,273954,267.5332031,336,90,426,
10,289034,282.2597656,4573,4450,9023,
10,304108,296.9804688,1374,1294,2668,
10,319180,311.6992188,565,484,1049,
10,334262,326.4277344,547,447,994,
10,349328,341.140625,374,310,684,
10,364408,355.8671875,485,418,903,
10,379472,370.578125,581,497,1078,
10,394566,385.3183594,480,386,866,
10,409640,400.0390625,622,517,1139,
10,424730,414.7753906,643,553,1196,
10,439812,429.5039063,737,646,1383,
10,454902,444.2402344,609,522,1131,
10,469984,458.96875,602,500,1102,
10,485054,473.6855469,668,560,1228,
10,500126,488.4042969,646,521,1167,
10,515202,503.1269531,565,461,1026,
10,530292,517.8632813,752,671,1423,
10,545390,532.6074219,689,589,1278,
10,560452,547.3164063,655,544,1199,
10,575532,562.0429688,437,353,790,
10,590614,576.7714844,605,509,1114,
10,605694,591.4980469,1406,1035,2441,
10,620760,606.2109375,1238,939,2177,
10,635832,620.9296875,1038,699,1737,
10,650912,635.65625,798,684,1482,
10,665990,650.3808594,1171,1064,2235,
10,681084,665.1210938,1570,1106,2676,
10,696158,679.8417969,1439,1041,2480,
10,711244,694.5742188,1128,994,2122,
10,726322,709.2988281,1464,1308,2772,
10,741390,724.0136719,1314,1144,2458,
10,756466,738.7363281,1733,1549,3282,
10,771542,753.4589844,1435,1322,2757,
10,786612,768.1757813,1751,1592,3343,
10,801686,782.8964844,1764,1641,3405,
10,816752,797.609375,1418,1281,2699,
10,831130,811.6503906,1668,1525,3193,
10,845506,825.6894531,1503,1368,2871,
10,859876,839.7226563,1654,1535,3189,
10,874240,853.75,1723,1589,3312,
10,888620,867.7929688,1739,1607,3346,
10,903004,881.8398438,1654,1522,3176,
10,917388,895.8867188,1793,1670,3463,
10,931768,909.9296875,1851,1700,3551,
10,946132,923.9570313,1656,1515,3171,
10,960506,937.9941406,1657,1529,3186,
10,974886,952.0371094,1728,1553,3281,
10,989262,966.0761719,2449,2288,4737,
10,1003630,980.1074219,2748,2613,5361,
10,1017994,994.1347656,2320,2164,4484,
10,1032370,1008.173828,2667,2501,5168,
10,1046744,1022.210938,2472,2282,4754,
10,1061118,1036.248047,2371,2215,4586,
10,1075490,1050.283203,2419,2261,4680,
10,1089872,1064.328125,2334,2198,4532,
10,1104244,1078.363281,2427,2288,4715,
10,1118624,1092.40625,2296,2097,4393,
10,1133002,1106.447266,2371,2179,4550,
10,1147364,1120.472656,2385,2184,4569,
10,1161736,1134.507813,2328,2137,4465,
10,1176104,1148.539063,2297,2124,4421,
10,1190482,1162.580078,2415,2238,4653,
10,1204858,1176.619141,2474,2270,4744,
10,1219222,1190.646484,2351,2182,4533,
10,1233606,1204.693359,2508,2325,4833,
10,1247994,1218.744141,2830,2646,5476,
10,1262368,1232.78125,2583,2345,4928,
10,1276732,1246.808594,2454,2235,4689,
10,1291086,1260.826172,2685,2499,5184,
10,1305470,1274.873047,2484,2306,4790,
10,1319840,1288.90625,3681,3482,7163,
10,1334210,1302.939453,3464,3263,6727,
10,1348584,1316.976563,3331,3149,6480,
10,1362968,1331.023438,4142,3946,8088,
10,1377328,1345.046875,4042,3813,7855,
10,1391708,1359.089844,3645,3428,7073,
10,1406104,1373.148438,3352,3090,6442,
10,1420488,1387.195313,3440,3197,6637,
10,1434862,1401.232422,3330,3000,6330,
10,1449244,1415.277344,3362,3141,6503,
10,1463634,1429.330078,3456,3236,6692,
10,1478012,1443.371094,3282,3069,6351,
10,1492392,1457.414063,3581,3356,6937,
10,1506788,1471.472656,3444,3229,6673,
10,1521156,1485.503906,3535,3285,6820,
10,1535528,1499.539063,3477,3260,6737,
10,1549888,1513.5625,3898,3635,7533,
10,1564258,1527.595703,3552,3249,6801,
10,1578620,1541.621094,3643,3414,7057,
10,1592986,1555.650391,3624,3398,7022,
10,1607352,1569.679688,3429,3184,6613,
10,1621724,1583.714844,4099,3874,7973,
10,1636104,1597.757813,3517,3258,6775,
10,1650490,1611.806641,3575,3353,6928,
10,1664884,1625.863281,4843,4589,9432,
10,1679256,1639.898438,4568,4286,8854,
10,1693646,1653.951172,4671,4325,8996,
10,1708020,1667.988281,4844,4281,9125,
10,1722390,1682.021484,4853,3236,8089,
10,1736772,1696.066406,4632,4151,8783,
10,1751150,1710.107422,4845,3218,8063,
10,1765526,1724.146484,5248,4758,10006,
10,1779912,1738.195313,4683,4430,9113,
10,1794286,1752.232422,4742,4447,9189,
10,1808660,1766.269531,4817,4512,9329,
10,1823038,1780.310547,4815,4360,9175,
10,1837422,1794.357422,4240,3922,8162,
10,1851802,1808.400391,4369,4068,8437,
10,1866172,1822.433594,4274,3983,8257,
10,1880544,1836.46875,4440,4087,8527,
10,1894930,1850.517578,4291,3966,8257,
10,1909306,1864.556641,4561,4162,8723,
10,1923686,1878.599609,4341,4060,8401,
10,1938052,1892.628906,4385,4074,8459,
10,1952430,1906.669922,4352,4053,8405,
10,1966820,1920.722656,4475,4144,8619,
10,1981196,1934.761719,4332,4013,8345,
10,1995570,1948.798828,6250,5389,11639,
10,2009944,1962.835938,5828,4815,10643,
10,2024334,1976.888672,5448,5102,10550,
10,2038722,1990.939453,5676,5331,11007,
10,2053088,2004.96875,5680,5328,11008,
10,2067476,2019.019531,6281,5969,12250,
10,2081842,2033.048828,5601,5270,10871,
10,2096216,2047.085938,5756,5389,11145,
10,2110610,2061.142578,5567,5245,10812,BAn20m10 (iteration 1)
10,15170,14.81445313,150,87,237,
10,29544,28.8515625,132,79,211,
10,43922,42.89257813,124,68,192,
10,58286,56.91992188,253,171,424,
10,72684,70.98046875,154,87,241,
10,87066,85.02539063,192,103,295,
10,101428,99.05078125,181,80,261,
10,115794,113.0800781,168,77,245,
10,130152,127.1015625,232,93,325,
10,144528,141.140625,246,99,345,
10,158900,155.1757813,257,101,358,
10,173288,169.2265625,281,102,383,
10,187666,183.2675781,557,235,792,
10,202046,197.3105469,325,93,418,
10,216430,211.3574219,3060,2746,5806,
10,230806,225.3964844,376,117,493,
10,245184,239.4375,253,93,346,
10,259546,253.4628906,394,220,614,
10,273906,267.4863281,423,102,525,
10,288988,282.2148438,7060,6904,13964,
10,304064,296.9375,1408,1296,2704,
10,319150,311.6699219,498,368,866,
10,334214,326.3808594,354,248,602,
10,349290,341.1035156,616,538,1154,
10,364378,355.8378906,556,458,1014,
10,379468,370.5742188,468,392,860,
10,394552,385.3046875,451,367,818,
10,409624,400.0234375,585,476,1061,
10,424714,414.7597656,748,444,1192,
10,439792,429.484375,559,445,1004,
10,454870,444.2089844,739,489,1228,
10,469960,458.9453125,735,432,1167,
10,485042,473.6738281,629,456,1085,
10,500122,488.4003906,529,445,974,
10,515202,503.1269531,573,485,1058,
10,530276,517.8476563,858,713,1571,
10,545354,532.5722656,798,694,1492,
10,560432,547.296875,700,602,1302,
10,575512,562.0234375,1021,512,1533,
10,590598,576.7558594,724,586,1310,
10,605672,591.4765625,1617,669,2286,
10,620740,606.1914063,1315,917,2232,
10,635818,620.9160156,1152,893,2045,
10,650898,635.6425781,1188,1000,2188,
10,665976,650.3671875,1546,1412,2958,
10,681048,665.0859375,1512,1367,2879,
10,696116,679.8007813,1458,1125,2583,
10,711200,694.53125,1391,1107,2498,
10,726276,709.2539063,1445,1122,2567,
10,741350,723.9746094,1380,1209,2589,
10,756418,738.6894531,1658,1540,3198,
10,771496,753.4140625,1373,1257,2630,
10,786586,768.1503906,1380,1141,2521,
10,801648,782.859375,1273,1150,2423,
10,816718,797.5761719,1747,1312,3059,
10,831086,811.6074219,1875,1725,3600,
10,845454,825.6386719,1794,1655,3449,
10,859826,839.6738281,1520,1380,2900,
10,874204,853.7148438,1779,1633,3412,
10,888578,867.7519531,1700,1581,3281,
10,902944,881.78125,1749,1594,3343,
10,917312,895.8125,1858,1720,3578,
10,931698,909.8613281,1734,1608,3342,
10,946066,923.8925781,1775,1637,3412,
10,960448,937.9375,2071,1939,4010,
10,974832,951.984375,2423,2203,4626,
10,989196,966.0117188,2640,2478,5118,
10,1003574,980.0527344,2588,2001,4589,
10,1017952,994.09375,2549,2415,4964,
10,1032324,1008.128906,2705,2534,5239,
10,1046708,1022.175781,2468,2333,4801,
10,1061090,1036.220703,2567,2421,4988,
10,1075466,1050.259766,2679,2535,5214,
10,1089840,1064.296875,2576,2426,5002,
10,1104234,1078.353516,2663,2485,5148,
10,1118616,1092.398438,2823,2647,5470,
10,1133000,1106.445313,3081,2865,5946,
10,1147372,1120.480469,2956,2759,5715,
10,1161746,1134.517578,2862,2642,5504,
10,1176120,1148.554688,2840,2628,5468,
10,1190488,1162.585938,2840,2678,5518,
10,1204864,1176.625,2812,2623,5435,
10,1219244,1190.667969,2896,2690,5586,
10,1233616,1204.703125,2831,2637,5468,
10,1247984,1218.734375,3081,2892,5973,
10,1262360,1232.773438,2987,2744,5731,
10,1276740,1246.816406,2904,2638,5542,
10,1291106,1260.845703,2899,2684,5583,
10,1305490,1274.892578,2965,2767,5732,
10,1319860,1288.925781,3614,3395,7009,
10,1334236,1302.964844,3779,3545,7324,
10,1348618,1317.009766,3839,3638,7477,
10,1363000,1331.054688,3789,3569,7358,
10,1377376,1345.09375,3856,3636,7492,
10,1391766,1359.146484,3829,3603,7432,
10,1406142,1373.185547,3966,3707,7673,
10,1420518,1387.224609,3840,3631,7471,
10,1434890,1401.259766,3926,3707,7633,
10,1449252,1415.285156,3775,3566,7341,
10,1463634,1429.330078,4115,3900,8015,
10,1478008,1443.367188,3885,3677,7562,
10,1492374,1457.396484,3854,3643,7497,
10,1506756,1471.441406,3935,3692,7627,
10,1521136,1485.484375,3937,3697,7634,
10,1535516,1499.527344,4065,3827,7892,
10,1549894,1513.568359,3865,3575,7440,
10,1564276,1527.613281,4184,3899,8083,
10,1578650,1541.650391,3992,3699,7691,
10,1593024,1555.6875,4096,3840,7936,
10,1607412,1569.738281,4631,3995,8626,
10,1621786,1583.775391,4098,3828,7926,
10,1636164,1597.816406,4096,3810,7906,
10,1650544,1611.859375,4063,3825,7888,
10,1664924,1625.902344,5587,5297,10884,
10,1679296,1639.9375,5077,4819,9896,
10,1693672,1653.976563,4567,4223,8790,
10,1708066,1668.033203,5124,4792,9916,
10,1722448,1682.078125,4999,4722,9721,
10,1736814,1696.107422,5138,4862,10000,
10,1751190,1710.146484,4901,4619,9520,
10,1765582,1724.201172,5158,4806,9964,
10,1779952,1738.234375,5186,4858,10044,
10,1794336,1752.28125,5201,4931,10132,
10,1808716,1766.324219,5132,4857,9989,
10,1823096,1780.367188,5169,4872,10041,
10,1837474,1794.408203,5033,4681,9714,
10,1851856,1808.453125,5002,4663,9665,
10,1866238,1822.498047,5148,4777,9925,
10,1880608,1836.53125,5567,5264,10831,
10,1894994,1850.580078,4989,4658,9647,
10,1909364,1864.613281,4867,4550,9417,
10,1923752,1878.664063,5341,5030,10371,
10,1938136,1892.710938,5664,5342,11006,
10,1952504,1906.742188,5255,4903,10158,
10,1966874,1920.775391,5587,5261,10848,
10,1981254,1934.818359,4277,3576,7853,
10,1995630,1948.857422,6117,5479,11596,
10,2010000,1962.890625,5541,5214,10755,
10,2024380,1976.933594,5653,5302,10955,
10,2038736,1990.953125,5764,5433,11197,
10,2053096,2004.976563,6292,5896,12188,
10,2067466,2019.009766,5623,5212,10835,
10,2081850,2033.056641,5576,5221,10797,
10,2096218,2047.087891,5580,5262,10842,
10,2110594,2061.126953,5790,5449,11239,BAn20m2 (iteration 2)
10,15194,14.83789063,263,164,427,
10,29572,28.87890625,211,137,348,
10,43956,42.92578125,144,86,230,
10,58318,56.95117188,160,90,250,
10,72696,70.9921875,163,93,256,
10,87066,85.02539063,165,82,247,
10,101456,99.078125,140,79,219,
10,115836,113.1210938,185,99,284,
10,130214,127.1621094,204,97,301,
10,144594,141.2050781,219,102,321,
10,158966,155.2402344,212,113,325,
10,173344,169.28125,243,110,353,
10,187724,183.3242188,255,110,365,
10,202104,197.3671875,223,95,318,
10,216472,211.3984375,3750,3641,7391,
10,230848,225.4375,234,95,329,
10,245250,239.5019531,250,86,336,
10,259632,253.546875,262,124,386,
10,274006,267.5839844,300,137,437,
10,289088,282.3125,844,736,1580,
10,304156,297.0273438,1339,1275,2614,
10,319236,311.7539063,4788,4707,9495,
10,334320,326.484375,964,891,1855,
10,349402,341.2128906,308,201,509,
10,364464,355.921875,3887,3800,7687,
10,379550,370.6542969,577,484,1061,
10,394640,385.390625,757,658,1415,
10,409722,400.1191406,768,593,1361,
10,424802,414.8457031,730,520,1250,
10,439880,429.5703125,776,517,1293,
10,454970,444.3066406,521,374,895,
10,470048,459.03125,642,559,1201,
10,485128,473.7578125,687,576,1263,
10,500208,488.484375,666,524,1190,
10,515270,503.1933594,669,552,1221,
10,530348,517.9179688,622,521,1143,
10,545440,532.65625,718,637,1355,
10,560522,547.3847656,599,463,1062,
10,575600,562.109375,802,709,1511,
10,590672,576.828125,784,679,1463,
10,605752,591.5546875,1551,1367,2918,
10,620838,606.2871094,972,868,1840,
10,635910,621.0058594,997,885,1882,
10,650978,635.7207031,1201,1098,2299,
10,666050,650.4394531,1246,1136,2382,
10,681126,665.1621094,1344,1197,2541,
10,696216,679.8984375,1561,1456,3017,
10,711292,694.6210938,1207,1097,2304,
10,726364,709.3398438,1283,1158,2441,
10,741428,724.0507813,1502,1361,2863,
10,756508,738.7773438,1616,1495,3111,
10,771582,753.4980469,1544,1428,2972,
10,786682,768.2441406,1780,1604,3384,
10,801766,782.9746094,1745,1606,3351,
10,816848,797.703125,1747,1259,3006,
10,831214,811.7324219,2124,1960,4084,
10,845606,825.7871094,1976,1841,3817,
10,859990,839.8339844,1889,1765,3654,
10,874368,853.875,1921,1779,3700,
10,888760,867.9296875,1945,1806,3751,
10,903124,881.9570313,1953,1807,3760,
10,917500,895.9960938,2007,1875,3882,
10,931880,910.0390625,1923,1775,3698,
10,946268,924.0898438,1987,1832,3819,
10,960648,938.1328125,1991,1838,3829,
10,975020,952.1679688,1966,1806,3772,
10,989402,966.2128906,3092,2948,6040,
10,1003784,980.2578125,2447,2300,4747,
10,1018166,994.3027344,2663,2512,5175,
10,1032532,1008.332031,2583,2430,5013,
10,1046910,1022.373047,2498,2339,4837,
10,1061282,1036.408203,2537,2389,4926,
10,1075654,1050.443359,2864,2692,5556,
10,1090034,1064.486328,2681,2549,5230,
10,1104420,1078.535156,2520,2355,4875,
10,1118790,1092.568359,2646,2445,5091,
10,1133172,1106.613281,2637,2440,5077,
10,1147544,1120.648438,2485,2318,4803,
10,1161912,1134.679688,2690,2507,5197,
10,1176304,1148.734375,2700,2510,5210,
10,1190702,1162.794922,2602,2406,5008,
10,1205084,1176.839844,2593,2427,5020,
10,1219458,1190.876953,2729,2561,5290,
10,1233842,1204.923828,2603,2435,5038,
10,1248234,1218.978516,2590,2422,5012,
10,1262608,1233.015625,2793,2551,5344,
10,1276986,1247.056641,2578,2371,4949,
10,1291352,1261.085938,2628,2432,5060,
10,1305720,1275.117188,2732,2545,5277,
10,1320082,1289.142578,3345,3094,6439,
10,1334442,1303.166016,3497,3312,6809,
10,1348824,1317.210938,3618,3389,7007,
10,1363192,1331.242188,3951,3763,7714,
10,1377568,1345.28125,3562,3360,6922,
10,1391936,1359.3125,3522,3225,6747,
10,1406330,1373.369141,3607,3380,6987,
10,1420698,1387.400391,3454,3251,6705,
10,1435076,1401.441406,3591,3392,6983,
10,1449458,1415.486328,4017,3787,7804,
10,1463842,1429.533203,3556,3320,6876,
10,1478210,1443.564453,3686,3445,7131,
10,1492594,1457.611328,3643,3389,7032,
10,1506972,1471.652344,3713,3501,7214,
10,1521356,1485.699219,3463,3223,6686,
10,1535728,1499.734375,3635,3393,7028,
10,1550108,1513.777344,3667,3369,7036,
10,1564480,1527.8125,3783,3540,7323,
10,1578856,1541.851563,3729,3505,7234,
10,1593230,1555.888672,3750,3506,7256,
10,1607618,1569.939453,3616,3358,6974,
10,1621982,1583.966797,3641,3407,7048,
10,1636360,1598.007813,3769,3544,7313,
10,1650736,1612.046875,3689,3449,7138,
10,1665100,1626.074219,5108,4822,9930,
10,1679482,1640.119141,4800,4533,9333,
10,1693860,1654.160156,4937,4615,9552,
10,1708252,1668.214844,5023,4761,9784,
10,1722620,1682.246094,4667,4425,9092,
10,1736994,1696.283203,4807,4545,9352,
10,1751380,1710.332031,4757,4509,9266,
10,1765750,1724.365234,4903,4637,9540,
10,1780122,1738.400391,4743,4464,9207,
10,1794490,1752.431641,4942,4673,9615,
10,1808858,1766.462891,5351,5065,10416,
10,1823230,1780.498047,4874,4591,9465,
10,1837608,1794.539063,4935,4599,9534,
10,1851986,1808.580078,4715,4381,9096,
10,1866362,1822.619141,4980,4695,9675,
10,1880748,1836.667969,4862,4576,9438,
10,1895122,1850.705078,4877,4547,9424,
10,1909494,1864.740234,4925,4616,9541,
10,1923894,1878.802734,4863,4526,9389,
10,1938256,1892.828125,4921,4634,9555,
10,1952624,1906.859375,4995,4670,9665,
10,1967000,1920.898438,4969,4644,9613,
10,1981384,1934.945313,4456,4046,8502,
10,1995762,1948.986328,5908,5616,11524,
10,2010140,1963.027344,5503,5205,10708,
10,2024514,1977.064453,5683,5369,11052,
10,2038896,1991.109375,5578,5253,10831,
10,2053270,2005.146484,5580,5255,10835,
10,2067636,2019.175781,6422,6114,12536,
10,2082012,2033.214844,5835,5440,11275,
10,2096404,2047.269531,5731,5354,11085,
10,2110778,2061.306641,5933,5576,11509,BAn20m10 (iteration 3)
10,15170,14.81445313,161,88,249,
10,29546,28.85351563,144,80,224,
10,43928,42.8984375,147,86,233,
10,58312,56.9453125,216,123,339,
10,72680,70.9765625,173,99,272,
10,87060,85.01953125,140,80,220,
10,101434,99.05664063,171,105,276,
10,115808,113.09375,152,85,237,
10,130198,127.1464844,184,109,293,
10,144574,141.1855469,204,115,319,
10,158956,155.2304688,182,85,267,
10,173340,169.2773438,189,88,277,
10,187716,183.3164063,200,86,286,
10,202080,197.34375,205,84,289,
10,216454,211.3808594,4190,4070,8260,
10,230834,225.4238281,204,88,292,
10,245208,239.4609375,221,105,326,
10,259606,253.5214844,231,104,335,
10,273982,267.5605469,247,112,359,
10,289062,282.2871094,7445,7371,14816,
10,304160,297.03125,1494,1422,2916,
10,319250,311.7675781,483,414,897,
10,334326,326.4902344,505,411,916,
10,349414,341.2246094,472,395,867,
10,364478,355.9355469,570,479,1049,
10,379552,370.65625,562,484,1046,
10,394640,385.390625,559,475,1034,
10,409710,400.1074219,608,371,979,
10,424774,414.8183594,650,464,1114,
10,439852,429.5429688,757,509,1266,
10,454932,444.2695313,672,368,1040,
10,470004,458.9882813,659,436,1095,
10,485072,473.703125,673,530,1203,
10,500152,488.4296875,621,516,1137,
10,515228,503.1523438,820,714,1534,
10,530302,517.8730469,598,504,1102,
10,545370,532.5878906,785,682,1467,
10,560452,547.3164063,501,407,908,
10,575528,562.0390625,645,549,1194,
10,590602,576.7597656,615,533,1148,
10,605664,591.46875,1429,1265,2694,
10,620734,606.1855469,992,882,1874,
10,635812,620.9101563,1087,968,2055,
10,650868,635.6132813,1176,1079,2255,
10,665952,650.34375,1110,1005,2115,
10,681026,665.0644531,1298,1172,2470,
10,696116,679.8007813,1350,1245,2595,
10,711204,694.5351563,1329,1220,2549,
10,726274,709.2519531,1247,1137,2384,
10,741350,723.9746094,1375,1251,2626,
10,756434,738.7050781,1373,1249,2622,
10,771520,753.4375,1504,1391,2895,
10,786608,768.171875,1653,1528,3181,
10,801682,782.8925781,1682,1537,3219,
10,816738,797.5957031,1628,1125,2753,
10,831120,811.640625,1802,1671,3473,
10,845504,825.6875,1902,1786,3688,
10,859874,839.7207031,1752,1621,3373,
10,874236,853.7460938,1857,1727,3584,
10,888604,867.7773438,1787,1669,3456,
10,902994,881.8300781,1769,1651,3420,
10,917360,895.859375,1719,1596,3315,
10,931738,909.9003906,1913,1781,3694,
10,946110,923.9355469,1867,1732,3599,
10,960498,937.9863281,1724,1602,3326,
10,974870,952.0214844,2207,2049,4256,
10,989250,966.0644531,2668,2508,5176,
10,1003620,980.0976563,2774,2638,5412,
10,1018002,994.1425781,2654,2488,5142,
10,1032386,1008.189453,2691,2554,5245,
10,1046760,1022.226563,2683,2536,5219,
10,1061128,1036.257813,2744,2583,5327,
10,1075500,1050.292969,2593,2421,5014,
10,1089870,1064.326172,2878,2711,5589,
10,1104236,1078.355469,2773,2613,5386,
10,1118608,1092.390625,2705,2502,5207,
10,1132990,1106.435547,2665,2492,5157,
10,1147386,1120.494141,2783,2574,5357,
10,1161750,1134.521484,2627,2436,5063,
10,1176128,1148.5625,2807,2635,5442,
10,1190498,1162.595703,2768,2586,5354,
10,1204878,1176.638672,2733,2549,5282,
10,1219248,1190.671875,2676,2494,5170,
10,1233624,1204.710938,3137,2953,6090,
10,1247992,1218.742188,2629,2415,5044,
10,1262370,1232.783203,2516,2276,4792,
10,1276754,1246.830078,2799,1918,4717,
10,1291122,1260.861328,2543,2325,4868,
10,1305492,1274.894531,2539,2347,4886,
10,1319870,1288.935547,3349,3141,6490,
10,1334248,1302.976563,3374,3186,6560,
10,1348624,1317.015625,3535,3319,6854,
10,1363006,1331.060547,3608,3382,6990,
10,1377378,1345.095703,3430,3252,6682,
10,1391764,1359.144531,3429,3226,6655,
10,1406146,1373.189453,3591,3375,6966,
10,1420520,1387.226563,3589,3398,6987,
10,1434894,1401.263672,3369,3184,6553,
10,1449270,1415.302734,3555,3347,6902,
10,1463652,1429.347656,3502,3300,6802,
10,1478028,1443.386719,3517,3326,6843,
10,1492400,1457.421875,3504,3256,6760,
10,1506766,1471.451172,3591,3369,6960,
10,1521140,1485.488281,3518,3302,6820,
10,1535524,1499.535156,3511,3295,6806,
10,1549898,1513.572266,3661,3370,7031,
10,1564272,1527.609375,3520,3302,6822,
10,1578654,1541.654297,3632,3398,7030,
10,1593028,1555.691406,3664,3411,7075,
10,1607408,1569.734375,3549,3316,6865,
10,1621788,1583.777344,3522,3240,6762,
10,1636174,1597.826172,3763,3520,7283,
10,1650550,1611.865234,3648,3417,7065,
10,1664916,1625.894531,4936,4666,9602,
10,1679298,1639.939453,4537,4283,8820,
10,1693656,1653.960938,4842,4507,9349,
10,1708036,1668.003906,4724,4472,9196,
10,1722414,1682.044922,4651,4409,9060,
10,1736796,1696.089844,4632,4385,9017,
10,1751186,1710.142578,4739,4493,9232,
10,1765554,1724.173828,5034,4769,9803,
10,1779928,1738.210938,5079,4787,9866,
10,1794302,1752.248047,4988,4677,9665,
10,1808676,1766.285156,4602,4341,8943,
10,1823046,1780.318359,4764,4434,9198,
10,1837432,1794.367188,5220,4820,10040,
10,1851802,1808.400391,4754,4465,9219,
10,1866174,1822.435547,4965,4701,9666,
10,1880558,1836.482422,4745,4473,9218,
10,1894942,1850.529297,4940,4625,9565,
10,1909312,1864.5625,4789,4509,9298,
10,1923710,1878.623047,5009,4735,9744,
10,1938094,1892.669922,4834,4554,9388,
10,1952470,1906.708984,4851,4505,9356,
10,1966846,1920.748047,5031,4728,9759,
10,1981222,1934.787109,4242,3891,8133,
10,1995584,1948.8125,6042,5687,11729,
10,2009966,1962.857422,5469,5133,10602,
10,2024344,1976.898438,5690,5353,11043,
10,2038716,1990.933594,5726,5402,11128,
10,2053082,2004.962891,5812,5489,11301,
10,2067458,2019.001953,5746,5360,11106,
10,2081840,2033.046875,5594,5261,10855,
10,2096214,2047.083984,5480,5119,10599,
10,2110576,2061.109375,5496,5178,10674,BAn20m10 (iteration 4)
10,15158,14.80273438,156,95,251,
10,29534,28.84179688,163,82,245,
10,43896,42.8671875,160,79,239,
10,58242,56.87695313,131,78,209,
10,72614,70.91210938,159,70,229,
10,86994,84.95507813,132,68,200,
10,101368,98.9921875,158,87,245,
10,115774,113.0605469,166,77,243,
10,130168,127.1171875,153,85,238,
10,144552,141.1640625,169,80,249,
10,158932,155.2070313,128,64,192,
10,173290,169.2285156,207,152,359,
10,187672,183.2734375,160,87,247,
10,202074,197.3378906,132,74,206,
10,216432,211.359375,581,522,1103,
10,230812,225.4023438,147,88,235,
10,245176,239.4296875,597,544,1141,
10,259570,253.4863281,3342,3275,6617,
10,273948,267.5273438,175,98,273,
10,289022,282.2480469,3344,3257,6601,
10,304082,296.9550781,524,456,980,
10,319156,311.6757813,1406,1346,2752,
10,334234,326.4003906,978,885,1863,
10,349308,341.1210938,201,127,328,
10,364382,355.8417969,1116,1035,2151,
10,379452,370.5585938,635,556,1191,
10,394536,385.2890625,2262,2180,4442,
10,409632,400.03125,738,644,1382,
10,424708,414.7539063,560,467,1027,
10,439768,429.4609375,645,560,1205,
10,454862,444.2011719,570,487,1057,
10,469946,458.9316406,756,664,1420,
10,485030,473.6621094,585,500,1085,
10,500114,488.3925781,595,502,1097,
10,515186,503.1113281,876,786,1662,
10,530266,517.8378906,718,626,1344,
10,545328,532.546875,768,669,1437,
10,560410,547.2753906,509,428,937,
10,575484,561.9960938,645,556,1201,
10,590562,576.7207031,686,574,1260,
10,605638,591.4433594,1326,1204,2530,
10,620716,606.1679688,1082,985,2067,
10,635798,620.8964844,801,704,1505,
10,650886,635.6308594,997,899,1896,
10,665950,650.3417969,1192,1083,2275,
10,681036,665.0742188,1282,1162,2444,
10,696108,679.7929688,1441,1330,2771,
10,711194,694.5253906,1220,1105,2325,
10,726254,709.2324219,1470,1357,2827,
10,741328,723.953125,1323,1193,2516,
10,756400,738.671875,1120,969,2089,
10,771478,753.3964844,1413,1314,2727,
10,786556,768.1210938,1771,1647,3418,
10,801636,782.8476563,1711,1577,3288,
10,816702,797.5605469,1501,1329,2830,
10,831072,811.59375,1711,1581,3292,
10,845432,825.6171875,1595,1473,3068,
10,859798,839.6464844,1562,1454,3016,
10,874194,853.7050781,1604,1483,3087,
10,888572,867.7460938,1694,1568,3262,
10,902944,881.78125,1694,1535,3229,
10,917318,895.8183594,1597,1460,3057,
10,931692,909.8554688,1757,1631,3388,
10,946064,923.890625,1733,1592,3325,
10,960444,937.9335938,1678,1523,3201,
10,974834,951.9863281,1929,1776,3705,
10,989226,966.0410156,2982,2845,5827,
10,1003610,980.0878906,2663,2518,5181,
10,1017986,994.1269531,2468,2302,4770,
10,1032366,1008.169922,2548,2409,4957,
10,1046750,1022.216797,2583,2391,4974,
10,1061130,1036.259766,2534,2389,4923,
10,1075504,1050.296875,2640,2493,5133,
10,1089876,1064.332031,2546,2388,4934,
10,1104254,1078.373047,2596,2434,5030,
10,1118618,1092.400391,2565,2387,4952,
10,1133000,1106.445313,2647,2469,5116,
10,1147376,1120.484375,2487,2303,4790,
10,1161754,1134.525391,2655,2479,5134,
10,1176138,1148.572266,2591,2412,5003,
10,1190502,1162.599609,2615,2399,5014,
10,1204868,1176.628906,2536,2372,4908,
10,1219250,1190.673828,2643,2473,5116,
10,1233626,1204.712891,2579,2421,5000,
10,1247994,1218.744141,3040,2882,5922,
10,1262384,1232.796875,2951,2700,5651,
10,1276772,1246.847656,2880,2512,5392,
10,1291152,1260.890625,2662,2490,5152,
10,1305528,1274.929688,2730,2500,5230,
10,1319918,1288.982422,3344,3151,6495,
10,1334280,1303.007813,3523,3313,6836,
10,1348656,1317.046875,3593,3350,6943,
10,1363032,1331.085938,3616,3404,7020,
10,1377410,1345.126953,3690,3474,7164,
10,1391782,1359.162109,3570,3355,6925,
10,1406150,1373.193359,3660,3430,7090,
10,1420534,1387.240234,3523,3328,6851,
10,1434898,1401.267578,3666,3454,7120,
10,1449282,1415.314453,3500,3296,6796,
10,1463666,1429.361328,3393,3178,6571,
10,1478038,1443.396484,3644,3435,7079,
10,1492422,1457.443359,3525,3307,6832,
10,1506792,1471.476563,3509,3285,6794,
10,1521180,1485.527344,3584,3336,6920,
10,1535570,1499.580078,3707,3498,7205,
10,1549948,1513.621094,3478,3234,6712,
10,1564334,1527.669922,3829,3577,7406,
10,1578708,1541.707031,3621,3383,7004,
10,1593076,1555.738281,3797,3564,7361,
10,1607452,1569.777344,3686,3428,7114,
10,1621830,1583.818359,3886,3659,7545,
10,1636208,1597.859375,3832,3600,7432,
10,1650576,1611.890625,3678,3444,7122,
10,1664952,1625.929688,5121,4870,9991,
10,1679328,1639.96875,4929,4683,9612,
10,1693700,1654.003906,4857,4559,9416,
10,1708066,1668.033203,4788,4535,9323,
10,1722436,1682.066406,4830,4571,9401,
10,1736802,1696.095703,4763,4481,9244,
10,1751186,1710.142578,4668,4405,9073,
10,1765552,1724.171875,4912,4651,9563,
10,1779944,1738.226563,4851,4587,9438,
10,1794330,1752.275391,4871,4585,9456,
10,1808724,1766.332031,4690,4427,9117,
10,1823094,1780.365234,4894,4612,9506,
10,1837460,1794.394531,4897,4549,9446,
10,1851844,1808.441406,4827,4555,9382,
10,1866226,1822.486328,4886,4605,9491,
10,1880594,1836.517578,4881,4594,9475,
10,1894972,1850.558594,5010,4735,9745,
10,1909332,1864.582031,5036,4712,9748,
10,1923714,1878.626953,4988,4661,9649,
10,1938108,1892.683594,5047,4772,9819,
10,1952508,1906.746094,4882,4598,9480,
10,1966892,1920.792969,4953,4665,9618,
10,1981264,1934.828125,4225,3869,8094,
10,1995636,1948.863281,5872,5487,11359,
10,2010016,1962.90625,5561,5204,10765,
10,2024398,1976.951172,5480,5164,10644,
10,2038762,1990.978516,5579,5269,10848,
10,2053138,2005.017578,5543,5227,10770,
10,2067510,2019.052734,5673,5331,11004,
10,2081884,2033.089844,5636,5302,10938,
10,2096266,2047.134766,5548,5209,10757,
10,2110640,2061.171875,5603,5247,10850,BAn20m10 (iteration 5)
10,15158,14.80273438,141,86,227,
10,29532,28.83984375,121,81,202,
10,43906,42.87695313,136,84,220,
10,58288,56.921875,174,117,291,
10,72660,70.95703125,119,79,198,
10,87040,85,131,91,222,
10,101408,99.03125,137,89,226,
10,115796,113.0820313,137,88,225,
10,130180,127.1289063,140,89,229,
10,144570,141.1816406,138,83,221,
10,158952,155.2265625,116,70,186,
10,173330,169.2675781,137,73,210,
10,187708,183.3085938,133,74,207,
10,202086,197.3496094,135,75,210,
10,216470,211.3964844,149,100,249,
10,230862,225.4511719,134,77,211,
10,245228,239.4804688,151,79,230,
10,259588,253.5039063,148,85,233,
10,273984,267.5625,137,81,218,
10,288366,281.6074219,167,97,264,
10,302756,295.6601563,13354,13293,26647,
10,317138,309.7050781,2147,2074,4221,
10,331526,323.7558594,772,705,1477,
10,345904,337.796875,893,822,1715,
10,360270,351.8261719,748,675,1423,
10,374640,365.859375,784,708,1492,
10,389000,379.8828125,1003,926,1929,
10,403374,393.9199219,732,644,1376,
10,417738,407.9472656,818,750,1568,
10,432812,422.6679688,743,669,1412,
10,447882,437.3847656,983,904,1887,
10,462956,452.1054688,732,628,1360,
10,478024,466.8203125,634,555,1189,
10,493108,481.5507813,622,526,1148,
10,508162,496.2519531,566,466,1032,
10,523248,510.984375,634,556,1190,
10,538322,525.7050781,618,539,1157,
10,553394,540.4238281,688,592,1280,
10,568488,555.1640625,768,672,1440,
10,583548,569.8710938,649,535,1184,
10,598622,584.5917969,670,570,1240,
10,613702,599.3183594,692,589,1281,
10,628784,614.046875,1652,1554,3206,
10,643870,628.7792969,1261,1151,2412,
10,658938,643.4941406,1257,1141,2398,
10,674020,658.2226563,1265,1136,2401,
10,689092,672.9414063,1297,1171,2468,
10,704170,687.6660156,1327,1221,2548,
10,719238,702.3808594,1550,1446,2996,
10,734308,717.0976563,996,864,1860,
10,749390,731.8261719,1433,1319,2752,
10,764470,746.5527344,1498,1391,2889,
10,779554,761.2832031,1511,1363,2874,
10,794640,776.015625,1396,1280,2676,
10,809718,790.7402344,1491,1355,2846,
10,824800,805.46875,1242,1124,2366,
10,839880,820.1953125,1114,994,2108,
10,854958,834.9199219,1199,1085,2284,
10,870038,849.6464844,1283,1165,2448,
10,885126,864.3808594,1417,1293,2710,
10,900194,879.0957031,1275,1110,2385,
10,915284,893.8320313,1274,1132,2406,
10,930356,908.5507813,1963,1838,3801,
10,945428,923.2695313,1844,1696,3540,
10,960504,937.9921875,1589,1460,3049,
10,975600,952.734375,1650,1488,3138,
10,990668,967.4492188,2043,1883,3926,
10,1005734,982.1621094,2056,1899,3955,
10,1020816,996.890625,2162,1997,4159,
10,1035878,1011.599609,2214,2011,4225,
10,1050950,1026.318359,2060,1928,3988,
10,1066030,1041.044922,2189,2032,4221,
10,1081098,1055.759766,2176,2015,4191,
10,1096172,1070.480469,2262,2120,4382,
10,1111244,1085.199219,2151,1989,4140,
10,1126314,1099.916016,2232,2053,4285,
10,1141390,1114.638672,2487,2278,4765,
10,1156450,1129.345703,2184,2032,4216,
10,1171532,1144.074219,2299,2130,4429,
10,1186602,1158.791016,2364,2204,4568,
10,1201676,1173.511719,2441,2273,4714,
10,1216754,1188.236328,2333,2169,4502,
10,1231812,1202.941406,3418,3226,6644,
10,1246896,1217.671875,2475,2293,4768,
10,1261984,1232.40625,2861,2633,5494,
10,1277054,1247.123047,2614,2415,5029,
10,1292136,1261.851563,3042,2866,5908,
10,1307214,1276.576172,2809,2632,5441,
10,1322292,1291.300781,2979,2790,5769,
10,1337370,1306.025391,3377,3184,6561,
10,1352450,1320.751953,3261,3065,6326,
10,1367532,1335.480469,3498,3305,6803,
10,1382610,1350.205078,3283,3038,6321,
10,1397688,1364.929688,3584,3334,6918,
10,1412770,1379.658203,3324,3124,6448,
10,1427848,1394.382813,3283,3086,6369,
10,1442928,1409.109375,3399,3215,6614,
10,1458006,1423.833984,3329,3102,6431,
10,1473102,1438.576172,3379,3184,6563,
10,1488176,1453.296875,3564,3263,6827,
10,1503252,1468.019531,3350,3119,6469,
10,1518324,1482.738281,3437,3211,6648,
10,1533404,1497.464844,4677,4464,9141,
10,1548492,1512.199219,4033,3789,7822,
10,1563562,1526.916016,3985,3767,7752,
10,1578648,1541.648438,4242,3977,8219,
10,1593714,1556.361328,3852,3375,7227,
10,1608784,1571.078125,4190,3159,7349,
10,1623852,1585.792969,3723,3495,7218,
10,1638924,1600.511719,4446,3443,7889,
10,1653996,1615.230469,4094,3807,7901,
10,1669078,1629.958984,4630,4234,8864,
10,1684160,1644.6875,4775,3476,8251,
10,1699232,1659.40625,4989,4742,9731,
10,1714298,1674.119141,4071,3810,7881,
10,1729376,1688.84375,4106,3848,7954,
10,1744460,1703.574219,4213,3741,7954,
10,1759528,1718.289063,4298,4004,8302,
10,1774594,1733.001953,4285,3992,8277,
10,1789658,1747.712891,4376,4073,8449,
10,1804042,1761.759766,5053,4775,9828,
10,1818412,1775.792969,4820,4560,9380,
10,1832784,1789.828125,4731,4447,9178,
10,1847182,1803.888672,4733,4426,9159,
10,1861552,1817.921875,4990,4656,9646,
10,1875932,1831.964844,4778,4395,9173,
10,1890310,1846.005859,4793,4498,9291,
10,1904682,1860.041016,4765,4468,9233,
10,1919058,1874.080078,4895,4626,9521,
10,1933440,1888.125,4758,4490,9248,
10,1947828,1902.175781,5305,4985,10290,
10,1962200,1916.210938,5227,4877,10104,
10,1976574,1930.248047,5058,4756,9814,
10,1990952,1944.289063,6483,6168,12651,
10,2005334,1958.333984,5967,5650,11617,
10,2019712,1972.375,6153,5635,11788,
10,2034102,1986.427734,6066,5775,11841,
10,2048488,2000.476563,6157,5823,11980,
10,2062868,2014.519531,6194,5836,12030,
10,2077248,2028.5625,6111,5806,11917,
10,2091616,2042.59375,6121,5782,11903,
10,2105984,2056.625,6352,6009,12361,
10,2120350,2070.654297,6240,5892,12132,
10,2134718,2084.685547,6395,6028,12423,
10,2149094,2098.724609,6588,6147,12735,
10,2163458,2112.751953,6238,5592,11830,
10,2177828,2126.785156,6358,5454,11812,
10,2192214,2140.833984,6411,6042,12453,
10,2206592,2154.875,6974,6625,13599,
10,2220974,2168.919922,6150,5763,11913,
10,2235342,2182.951172,6290,5879,12169,
10,2249730,2197.001953,6228,5877,12105,
10,2264094,2211.029297,7220,6825,14045,
10,2278478,2225.076172,6290,5907,12197,
10,2292862,2239.123047,6402,6026,12428,
10,2307238,2253.162109,6499,6112,12611,
10,2321626,2267.212891,7594,7217,14811,
10,2336002,2281.251953,7742,7372,15114,
10,2350384,2295.296875,7830,7437,15267,
10,2364774,2309.349609,7817,7414,15231,
10,2379144,2323.382813,7899,7518,15417,
10,2393532,2337.433594,7749,7333,15082,
10,2407910,2351.474609,7930,7545,15475,
10,2422276,2365.503906,7941,7557,15498,
10,2436662,2379.552734,7804,7416,15220,
10,2451050,2393.603516,7361,6836,14197,
10,2465430,2407.646484,7148,6738,13886,
10,2479810,2421.689453,7248,6752,14000,
10,2494190,2435.732422,7342,6854,14196,
10,2508568,2449.773438,7116,6689,13805,
10,2522938,2463.806641,7304,6816,14120,
10,2537320,2477.851563,7315,6870,14185,
10,2551702,2491.896484,7415,6909,14324,
10,2566088,2505.945313,7803,7390,15193,
10,2580474,2519.994141,7516,7092,14608,
10,2594860,2534.042969,7530,7023,14553,
10,2609242,2548.087891,7380,6920,14300,
10,2623618,2562.126953,7346,6801,14147,
10,2637994,2576.166016,7350,6814,14164,
10,2652368,2590.203125,7290,6819,14109,BAn20m15 (iteration 1)
10,15176,14.8203125,114,78,192,
10,29538,28.84570313,139,87,226,
10,43914,42.88476563,146,98,244,
10,58282,56.91601563,158,108,266,
10,72666,70.96289063,173,115,288,
10,87038,84.99804688,160,108,268,
10,101418,99.04101563,125,73,198,
10,115794,113.0800781,136,89,225,
10,130184,127.1328125,127,80,207,
10,144556,141.1679688,128,67,195,
10,158924,155.1992188,131,82,213,
10,173296,169.234375,149,77,226,
10,187674,183.2753906,143,92,235,
10,202056,197.3203125,150,79,229,
10,216424,211.3515625,156,88,244,
10,230802,225.3925781,137,82,219,
10,245168,239.421875,176,109,285,
10,259554,253.4707031,155,87,242,
10,273948,267.5273438,130,70,200,
10,288332,281.5742188,150,84,234,
10,302718,295.6230469,4634,4563,9197,
10,317076,309.6445313,2929,2854,5783,
10,331452,323.6835938,480,412,892,
10,345824,337.71875,7527,7457,14984,
10,360198,351.7558594,580,499,1079,
10,374568,365.7890625,1156,1083,2239,
10,388936,379.8203125,1224,1146,2370,
10,403314,393.8613281,517,424,941,
10,417690,407.9003906,1159,1088,2247,
10,432774,422.6308594,597,515,1112,
10,447844,437.3476563,1364,1288,2652,
10,462934,452.0839844,737,637,1374,
10,478016,466.8125,633,554,1187,
10,493096,481.5390625,625,464,1089,
10,508158,496.2480469,631,539,1170,
10,523240,510.9765625,674,590,1264,
10,538314,525.6972656,570,485,1055,
10,553392,540.421875,656,558,1214,
10,568488,555.1640625,664,551,1215,
10,583562,569.8847656,588,482,1070,
10,598634,584.6035156,785,702,1487,
10,613720,599.3359375,782,617,1399,
10,628794,614.0566406,1451,1349,2800,
10,643870,628.7792969,1187,1090,2277,
10,658936,643.4921875,1212,1095,2307,
10,674002,658.2050781,1404,1295,2699,
10,689084,672.9335938,1246,1133,2379,
10,704162,687.6582031,1289,1179,2468,
10,719236,702.3789063,1443,1328,2771,
10,734326,717.1152344,1249,1133,2382,
10,749402,731.8378906,1439,1315,2754,
10,764488,746.5703125,1314,1191,2505,
10,779568,761.296875,1560,1457,3017,
10,794636,776.0117188,1469,1315,2784,
10,809718,790.7402344,1511,1374,2885,
10,824780,805.4492188,1182,1072,2254,
10,839860,820.1757813,1074,957,2031,
10,854922,834.8847656,1296,1156,2452,
10,870002,849.6113281,1248,1122,2370,
10,885086,864.3417969,1341,1221,2562,
10,900168,879.0703125,1197,1070,2267,
10,915246,893.7949219,1334,1199,2533,
10,930316,908.5117188,2117,1987,4104,
10,945384,923.2265625,1985,1850,3835,
10,960464,937.953125,1982,1797,3779,
10,975540,952.6757813,1726,1557,3283,
10,990614,967.3964844,2086,1852,3938,
10,1005694,982.1230469,2104,1938,4042,
10,1020770,996.8457031,2137,1980,4117,
10,1035834,1011.556641,2459,2290,4749,
10,1050904,1026.273438,2485,2313,4798,
10,1065984,1041,2620,2465,5085,
10,1081056,1055.71875,2945,2783,5728,
10,1096134,1070.443359,2453,2297,4750,
10,1111214,1085.169922,2399,2115,4514,
10,1126296,1099.898438,2461,2214,4675,
10,1141358,1114.607422,2592,2371,4963,
10,1156430,1129.326172,2521,2322,4843,
10,1171510,1144.052734,2469,2234,4703,
10,1186576,1158.765625,2433,2271,4704,
10,1201670,1173.505859,2382,2209,4591,
10,1216730,1188.212891,2302,2138,4440,
10,1231816,1202.945313,3392,3157,6549,
10,1246886,1217.662109,2611,2442,5053,
10,1261964,1232.386719,2721,2497,5218,
10,1277030,1247.099609,2716,2537,5253,
10,1292110,1261.826172,2827,2647,5474,
10,1307190,1276.552734,3069,2880,5949,
10,1322248,1291.257813,2756,2573,5329,
10,1337322,1305.978516,3327,3140,6467,
10,1352402,1320.705078,3201,3002,6203,
10,1367500,1335.449219,3298,3096,6394,
10,1382584,1350.179688,3333,3097,6430,
10,1397668,1364.910156,3211,3008,6219,
10,1412726,1379.615234,3363,3153,6516,
10,1427808,1394.34375,3384,3184,6568,
10,1442878,1409.060547,3339,3130,6469,
10,1457946,1423.775391,3388,3176,6564,
10,1473022,1438.498047,3381,3146,6527,
10,1488094,1453.216797,3426,3153,6579,
10,1503184,1467.953125,3492,3275,6767,
10,1518258,1482.673828,3556,3327,6883,
10,1533314,1497.376953,4663,4420,9083,
10,1548384,1512.09375,4054,3848,7902,
10,1563446,1526.802734,3973,3740,7713,
10,1578532,1541.535156,4168,2880,7048,
10,1593606,1556.255859,3763,3495,7258,
10,1608676,1570.972656,4055,3781,7836,
10,1623760,1585.703125,3885,3624,7509,
10,1638840,1600.429688,3999,3757,7756,
10,1653902,1615.138672,4032,3763,7795,
10,1668970,1629.853516,4670,4323,8993,
10,1684050,1644.580078,4726,4497,9223,
10,1699144,1659.320313,4774,4131,8905,
10,1714222,1674.044922,4248,3973,8221,
10,1729302,1688.771484,4196,3922,8118,
10,1744390,1703.505859,4217,3967,8184,
10,1759458,1718.220703,4230,3855,8085,
10,1774520,1732.929688,4366,4018,8384,
10,1789592,1747.648438,4299,4006,8305,
10,1803958,1761.677734,5185,4874,10059,
10,1818326,1775.708984,4899,4626,9525,
10,1832722,1789.767578,5072,4781,9853,
10,1847098,1803.806641,4910,4637,9547,
10,1861482,1817.853516,5018,4754,9772,
10,1875878,1831.912109,5269,4967,10236,
10,1890260,1845.957031,5195,4896,10091,
10,1904640,1860,5105,4783,9888,
10,1919010,1874.033203,5207,4905,10112,
10,1933388,1888.074219,5080,4763,9843,
10,1947780,1902.128906,5060,4764,9824,
10,1962140,1916.152344,5143,4360,9503,
10,1976522,1930.197266,5261,3934,9195,
10,1990908,1944.246094,6869,6505,13374,
10,2005296,1958.296875,6266,5953,12219,
10,2019668,1972.332031,6325,5935,12260,
10,2034046,1986.373047,6265,5930,12195,
10,2048422,2000.412109,6255,5922,12177,
10,2062796,2014.449219,6476,6088,12564,
10,2077174,2028.490234,6289,5965,12254,
10,2091556,2042.535156,6421,6092,12513,
10,2105930,2056.572266,6539,6207,12746,
10,2120320,2070.625,6374,6046,12420,
10,2134702,2084.669922,6861,6429,13290,
10,2149070,2098.701172,6537,6025,12562,
10,2163436,2112.730469,6388,6044,12432,
10,2177804,2126.761719,6439,5929,12368,
10,2192168,2140.789063,6528,6162,12690,
10,2206554,2154.837891,6610,6225,12835,
10,2220920,2168.867188,6542,6182,12724,
10,2235290,2182.900391,7392,6985,14377,
10,2249660,2196.933594,6544,6172,12716,
10,2264028,2210.964844,6629,6248,12877,
10,2278408,2225.007813,6574,6201,12775,
10,2292790,2239.052734,6479,6136,12615,
10,2307156,2253.082031,6609,6170,12779,
10,2321550,2267.138672,7741,7358,15099,
10,2335920,2281.171875,7935,7553,15488,
10,2350296,2295.210938,8070,7473,15543,
10,2364670,2309.248047,7900,7516,15416,
10,2379060,2323.300781,7928,7441,15369,
10,2393454,2337.357422,8057,7642,15699,
10,2407834,2351.400391,8118,7696,15814,
10,2422216,2365.445313,8104,7713,15817,
10,2436596,2379.488281,8042,7621,15663,
10,2450978,2393.533203,7223,6725,13948,
10,2465358,2407.576172,7204,6799,14003,
10,2479738,2421.619141,7286,6819,14105,
10,2494100,2435.644531,7328,6905,14233,
10,2508476,2449.683594,7322,6863,14185,
10,2522856,2463.726563,7251,6796,14047,
10,2537230,2477.763672,7394,6916,14310,
10,2551598,2491.794922,7374,6951,14325,
10,2565976,2505.835938,7395,6933,14328,
10,2580358,2519.880859,7522,7030,14552,
10,2594730,2533.916016,7520,7101,14621,
10,2609116,2547.964844,7454,6910,14364,
10,2623490,2562.001953,7632,7171,14803,
10,2637866,2576.041016,7528,7083,14611,
10,2652250,2590.087891,7476,6987,14463,BAn20m15 (iteration 2)
10,15176,14.8203125,153,94,247,
10,29554,28.86132813,173,108,281,
10,43938,42.90820313,137,73,210,
10,58324,56.95703125,153,81,234,
10,72698,70.99414063,167,87,254,
10,87082,85.04101563,181,75,256,
10,101454,99.07617188,188,90,278,
10,115848,113.1328125,196,85,281,
10,130206,127.1542969,171,65,236,
10,144568,141.1796875,178,87,265,
10,158956,155.2304688,371,290,661,
10,173330,169.2675781,164,73,237,
10,187716,183.3164063,155,73,228,
10,202080,197.34375,131,77,208,
10,216444,211.3710938,122,71,193,
10,230822,225.4121094,169,97,266,
10,245200,239.453125,163,95,258,
10,259592,253.5078125,159,106,265,
10,273978,267.5566406,135,74,209,
10,288360,281.6015625,145,84,229,
10,302734,295.6386719,4018,3952,7970,
10,317114,309.6816406,4425,4344,8769,
10,331504,323.734375,7973,7907,15880,
10,345906,337.7988281,674,563,1237,
10,360284,351.8398438,1372,1307,2679,
10,374666,365.8847656,1188,1125,2313,
10,389046,379.9277344,516,440,956,
10,403420,393.9648438,1232,1157,2389,
10,417792,408,578,501,1079,
10,432880,422.734375,1275,1195,2470,
10,447972,437.4726563,651,567,1218,
10,463054,452.2011719,709,604,1313,
10,478128,466.921875,609,522,1131,
10,493208,481.6484375,545,447,992,
10,508286,496.3730469,561,488,1049,
10,523362,511.0957031,704,619,1323,
10,538444,525.8242188,599,505,1104,
10,553518,540.5449219,727,620,1347,
10,568588,555.2617188,572,482,1054,
10,583680,570,756,650,1406,
10,598760,584.7265625,707,619,1326,
10,613846,599.4589844,590,485,1075,
10,628912,614.171875,1745,1639,3384,
10,643974,628.8808594,1160,1060,2220,
10,659068,643.6210938,986,879,1865,
10,674148,658.3476563,1408,1302,2710,
10,689234,673.0800781,1383,1267,2650,
10,704306,687.7988281,1202,1090,2292,
10,719384,702.5234375,1356,1223,2579,
10,734464,717.25,1575,1453,3028,
10,749542,731.9746094,1446,1329,2775,
10,764612,746.6914063,1383,1267,2650,
10,779686,761.4121094,1250,1136,2386,
10,794774,776.1464844,1060,926,1986,
10,809852,790.8710938,1750,1603,3353,
10,824930,805.5957031,1366,1232,2598,
10,840006,820.3183594,1176,1059,2235,
10,855086,835.0449219,1286,1152,2438,
10,870164,849.7695313,1203,1082,2285,
10,885246,864.4980469,1212,1099,2311,
10,900324,879.2226563,1308,1168,2476,
10,915406,893.9511719,1242,1113,2355,
10,930488,908.6796875,2118,1988,4106,
10,945572,923.4101563,1484,1349,2833,
10,960646,938.1308594,1553,1409,2962,
10,975720,952.8515625,1861,1677,3538,
10,990796,967.5742188,1791,1641,3432,
10,1005870,982.2949219,2079,1916,3995,
10,1020942,997.0136719,2232,2086,4318,
10,1036014,1011.732422,2129,1975,4104,
10,1051086,1026.451172,2199,2023,4222,
10,1066178,1041.189453,2253,2104,4357,
10,1081258,1055.916016,2213,2047,4260,
10,1096332,1070.636719,2810,2646,5456,
10,1111410,1085.361328,2156,1988,4144,
10,1126498,1100.095703,2368,2138,4506,
10,1141572,1114.816406,2215,2048,4263,
10,1156630,1129.521484,2395,2212,4607,
10,1171704,1144.242188,2303,2130,4433,
10,1186784,1158.96875,2315,2127,4442,
10,1201852,1173.683594,2274,2104,4378,
10,1216936,1188.414063,2399,2221,4620,
10,1232006,1203.130859,3457,3269,6726,
10,1247076,1217.847656,2686,2498,5184,
10,1262144,1232.5625,2882,2671,5553,
10,1277210,1247.275391,2636,2450,5086,
10,1292286,1261.998047,2891,2709,5600,
10,1307352,1276.710938,3128,2923,6051,
10,1322422,1291.427734,2821,2637,5458,
10,1337488,1306.140625,3288,3094,6382,
10,1352564,1320.863281,3319,3126,6445,
10,1367646,1335.591797,3266,3077,6343,
10,1382720,1350.3125,3376,3122,6498,
10,1397812,1365.050781,3401,3210,6611,
10,1412890,1379.775391,3422,3227,6649,
10,1427966,1394.498047,3372,3173,6545,
10,1443038,1409.216797,3344,3123,6467,
10,1458106,1423.931641,3540,3223,6763,
10,1473182,1438.654297,3441,3226,6667,
10,1488264,1453.382813,3489,3232,6721,
10,1503340,1468.105469,3511,3278,6789,
10,1518410,1482.822266,3445,3234,6679,
10,1533486,1497.544922,4863,4602,9465,
10,1548562,1512.267578,4015,3785,7800,
10,1563650,1527.001953,4066,3783,7849,
10,1578720,1541.71875,4202,3955,8157,
10,1593800,1556.445313,3976,3689,7665,
10,1608878,1571.169922,3985,3750,7735,
10,1623970,1585.908203,3914,3634,7548,
10,1639040,1600.625,4112,3881,7993,
10,1654116,1615.347656,4676,3918,8594,
10,1669198,1630.076172,4599,4353,8952,
10,1684288,1644.8125,4723,4469,9192,
10,1699370,1659.541016,4921,4672,9593,
10,1714444,1674.261719,4395,4132,8527,
10,1729520,1688.984375,4131,3880,8011,
10,1744590,1703.701172,4319,4040,8359,
10,1759678,1718.435547,4197,3893,8090,
10,1774740,1733.144531,4283,4012,8295,
10,1789808,1747.859375,4201,3874,8075,
10,1804198,1761.912109,5179,4845,10024,
10,1818578,1775.955078,4814,4522,9336,
10,1832962,1790.001953,5056,4769,9825,
10,1847334,1804.037109,4987,4698,9685,
10,1861716,1818.082031,5232,4958,10190,
10,1876088,1832.117188,5141,4845,9986,
10,1890470,1846.162109,5569,5290,10859,
10,1904848,1860.203125,5046,4744,9790,
10,1919202,1874.220703,5167,4862,10029,
10,1933586,1888.267578,5108,4823,9931,
10,1947962,1902.306641,5142,4820,9962,
10,1962322,1916.330078,5455,5126,10581,
10,1976700,1930.371094,5184,4728,9912,
10,1991076,1944.410156,6654,6310,12964,
10,2005442,1958.439453,6376,5801,12177,
10,2019814,1972.474609,5875,5470,11345,
10,2034180,1986.503906,6333,6009,12342,
10,2048538,2000.525391,6390,6077,12467,
10,2062916,2014.566406,6483,6149,12632,
10,2077284,2028.597656,6386,6055,12441,
10,2091666,2042.642578,6494,6158,12652,
10,2106032,2056.671875,6746,6399,13145,
10,2120406,2070.708984,6420,6071,12491,
10,2134784,2084.75,6465,6117,12582,
10,2149154,2098.783203,6583,6215,12798,
10,2163536,2112.828125,6465,6109,12574,
10,2177904,2126.859375,6407,6068,12475,
10,2192270,2140.888672,6513,6145,12658,
10,2206636,2154.917969,6525,6172,12697,
10,2221000,2168.945313,6515,6095,12610,
10,2235376,2182.984375,6489,6052,12541,
10,2249756,2197.027344,6515,6121,12636,
10,2264142,2211.076172,6534,6171,12705,
10,2278532,2225.128906,6501,6130,12631,
10,2292906,2239.166016,6509,6140,12649,
10,2307286,2253.208984,6655,6290,12945,
10,2321658,2267.244141,8284,7877,16161,
10,2336022,2281.271484,8102,7679,15781,
10,2350400,2295.3125,7900,7534,15434,
10,2364786,2309.361328,8049,7627,15676,
10,2379166,2323.404297,8010,7634,15644,
10,2393538,2337.439453,8269,7783,16052,
10,2407930,2351.494141,8165,7781,15946,
10,2422318,2365.544922,8263,7869,16132,
10,2436700,2379.589844,8555,8154,16709,
10,2451068,2393.621094,7307,6827,14134,
10,2465472,2407.6875,7217,6755,13972,
10,2479846,2421.724609,7274,6794,14068,
10,2494204,2435.746094,7313,6870,14183,
10,2508572,2449.777344,8119,7675,15794,
10,2522944,2463.8125,7342,6914,14256,
10,2537334,2477.865234,7606,6687,14293,
10,2551710,2491.904297,7372,6894,14266,
10,2566080,2505.9375,7094,6695,13789,
10,2580438,2519.958984,7273,6654,13927,
10,2594808,2533.992188,7369,6808,14177,
10,2609188,2548.035156,7351,6907,14258,
10,2623554,2562.064453,7481,6871,14352,
10,2637934,2576.107422,7465,6952,14417,
10,2652316,2590.152344,7458,6999,14457,BAn20m15 (iteration 3)
10,15172,14.81640625,133,85,218,
10,29548,28.85546875,205,155,360,
10,43910,42.88085938,153,102,255,
10,58286,56.91992188,123,76,199,
10,72666,70.96289063,124,81,205,
10,87032,84.9921875,116,75,191,
10,101396,99.01953125,139,94,233,
10,115762,113.0488281,125,80,205,
10,130134,127.0839844,158,82,240,
10,144530,141.1425781,135,89,224,
10,158920,155.1953125,146,95,241,
10,173294,169.2324219,145,92,237,
10,187662,183.2636719,152,97,249,
10,202046,197.3105469,147,94,241,
10,216422,211.3496094,142,78,220,
10,230810,225.4003906,140,83,223,
10,245180,239.4335938,137,80,217,
10,259556,253.4726563,143,85,228,
10,273928,267.5078125,161,101,262,
10,288314,281.5566406,135,79,214,
10,302696,295.6015625,18154,18095,36249,
10,317068,309.6367188,3070,2973,6043,
10,331442,323.6738281,1235,1168,2403,
10,345816,337.7109375,896,831,1727,
10,360192,351.75,920,854,1774,
10,374568,365.7890625,1230,1162,2392,
10,388950,379.8339844,619,546,1165,
10,403322,393.8691406,1171,1103,2274,
10,417694,407.9042969,542,457,999,
10,432758,422.6152344,1312,1240,2552,
10,447830,437.3339844,661,571,1232,
10,462908,452.0585938,695,620,1315,
10,477980,466.7773438,569,472,1041,
10,493048,481.4921875,526,441,967,
10,508124,496.2148438,592,510,1102,
10,523200,510.9375,655,561,1216,
10,538274,525.6582031,658,570,1228,
10,553346,540.3769531,700,598,1298,
10,568418,555.0957031,659,563,1222,
10,583490,569.8144531,596,509,1105,
10,598550,584.5214844,615,511,1126,
10,613628,599.2460938,668,555,1223,
10,628694,613.9589844,1380,1283,2663,
10,643778,628.6894531,1112,1005,2117,
10,658834,643.3925781,1131,1021,2152,
10,673918,658.1230469,1404,1303,2707,
10,689002,672.8535156,1049,928,1977,
10,704088,687.5859375,1454,1343,2797,
10,719170,702.3144531,1394,1248,2642,
10,734238,717.0292969,1200,1098,2298,
10,749316,731.7539063,1373,1270,2643,
10,764396,746.4804688,1319,1202,2521,
10,779476,761.2070313,1488,1358,2846,
10,794568,775.9453125,1049,923,1972,
10,809640,790.6640625,1579,1442,3021,
10,824712,805.3828125,1406,1285,2691,
10,839784,820.1015625,1242,1123,2365,
10,854868,834.8320313,1123,993,2116,
10,869940,849.5507813,1315,1190,2505,
10,885016,864.2734375,1373,1261,2634,
10,900096,879,1259,1096,2355,
10,915170,893.7207031,1109,969,2078,
10,930246,908.4433594,1970,1854,3824,
10,945332,923.1757813,1791,1665,3456,
10,960420,937.9101563,1613,1468,3081,
10,975496,952.6328125,1788,1639,3427,
10,990568,967.3515625,1930,1772,3702,
10,1005648,982.078125,2136,1992,4128,
10,1020728,996.8046875,2136,1989,4125,
10,1035808,1011.53125,2123,1946,4069,
10,1050888,1026.257813,2149,1988,4137,
10,1065958,1040.974609,2231,2061,4292,
10,1081028,1055.691406,2148,1993,4141,
10,1096094,1070.404297,2229,2053,4282,
10,1111184,1085.140625,2156,1965,4121,
10,1126268,1099.871094,2194,2012,4206,
10,1141362,1114.611328,2394,2220,4614,
10,1156438,1129.333984,2285,2112,4397,
10,1171532,1144.074219,2400,2223,4623,
10,1186612,1158.800781,2258,2074,4332,
10,1201686,1173.521484,2407,2191,4598,
10,1216758,1188.240234,2381,2185,4566,
10,1231844,1202.972656,3520,3336,6856,
10,1246924,1217.699219,2711,2495,5206,
10,1261998,1232.419922,2808,2619,5427,
10,1277086,1247.154297,2615,2442,5057,
10,1292174,1261.888672,3022,2843,5865,
10,1307238,1276.599609,2792,2594,5386,
10,1322320,1291.328125,2875,2700,5575,
10,1337412,1306.066406,3266,3069,6335,
10,1352488,1320.789063,3240,3038,6278,
10,1367562,1335.509766,3408,3200,6608,
10,1382628,1350.222656,3318,3039,6357,
10,1397702,1364.943359,3454,3255,6709,
10,1412780,1379.667969,3501,3307,6808,
10,1427874,1394.408203,3205,2997,6202,
10,1442954,1409.134766,3344,3145,6489,
10,1458032,1423.859375,3416,3206,6622,
10,1473122,1438.595703,3303,3072,6375,
10,1488212,1453.332031,3492,3217,6709,
10,1503298,1468.064453,3462,3239,6701,
10,1518368,1482.78125,3494,3278,6772,
10,1533442,1497.501953,4846,4617,9463,
10,1548504,1512.210938,4000,3743,7743,
10,1563594,1526.947266,4085,3817,7902,
10,1578654,1541.654297,4014,3686,7700,
10,1593732,1556.378906,3857,3634,7491,
10,1608810,1571.103516,4073,3787,7860,
10,1623886,1585.826172,3919,3698,7617,
10,1638956,1600.542969,3913,3657,7570,
10,1654024,1615.257813,4416,4135,8551,
10,1669104,1629.984375,4653,4382,9035,
10,1684180,1644.707031,4729,4493,9222,
10,1699274,1659.447266,4621,4362,8983,
10,1714358,1674.177734,4167,3897,8064,
10,1729430,1688.896484,4313,3998,8311,
10,1744508,1703.621094,4235,3788,8023,
10,1759578,1718.337891,4289,3984,8273,
10,1774660,1733.066406,4205,3905,8110,
10,1789730,1747.783203,4339,4018,8357,
10,1804102,1761.818359,5298,3605,8903,
10,1818476,1775.855469,5236,4206,9442,
10,1832846,1789.888672,4952,4653,9605,
10,1847220,1803.925781,5073,4780,9853,
10,1861608,1817.976563,5003,4683,9686,
10,1875986,1832.017578,5025,4685,9710,
10,1890360,1846.054688,4963,4577,9540,
10,1904732,1860.089844,5188,4890,10078,
10,1919104,1874.125,5110,4752,9862,
10,1933472,1888.15625,5071,4732,9803,
10,1947838,1902.185547,4964,4647,9611,
10,1962208,1916.21875,5040,4692,9732,
10,1976582,1930.255859,5252,3669,8921,
10,1990960,1944.296875,6682,6381,13063,
10,2005332,1958.332031,7821,4853,12674,
10,2019706,1972.369141,6327,5967,12294,
10,2034080,1986.40625,6234,5911,12145,
10,2048464,2000.453125,6256,5931,12187,
10,2062836,2014.488281,6364,6030,12394,
10,2077216,2028.53125,6303,5965,12268,
10,2091590,2042.568359,6376,6043,12419,
10,2105966,2056.607422,6369,6031,12400,
10,2120350,2070.654297,6331,6002,12333,
10,2134722,2084.689453,6403,6072,12475,
10,2149102,2098.732422,6387,6048,12435,
10,2163478,2112.771484,7494,7138,14632,
10,2177866,2126.822266,6693,6286,12979,
10,2192248,2140.867188,6531,6098,12629,
10,2206622,2154.904297,6319,5942,12261,
10,2221004,2168.949219,6407,6028,12435,
10,2235380,2182.988281,6470,6069,12539,
10,2249758,2197.029297,6379,6027,12406,
10,2264134,2211.068359,6530,6128,12658,
10,2278504,2225.101563,7195,6770,13965,
10,2292888,2239.148438,6565,6091,12656,
10,2307274,2253.197266,6646,6290,12936,
10,2321658,2267.244141,7720,7296,15016,
10,2336036,2281.285156,8039,7673,15712,
10,2350412,2295.324219,7883,7512,15395,
10,2364778,2309.353516,7986,7578,15564,
10,2379156,2323.394531,7930,7532,15462,
10,2393528,2337.429688,8094,7687,15781,
10,2407898,2351.462891,7983,7586,15569,
10,2422256,2365.484375,8043,7660,15703,
10,2436644,2379.535156,8012,7605,15617,
10,2451016,2393.570313,7321,6672,13993,
10,2465384,2407.601563,7260,6781,14041,
10,2479752,2421.632813,7278,6815,14093,
10,2494122,2435.666016,8079,7655,15734,
10,2508510,2449.716797,7256,6813,14069,
10,2522888,2463.757813,7442,7026,14468,
10,2537268,2477.800781,7359,6889,14248,
10,2551642,2491.837891,7372,6920,14292,
10,2566006,2505.865234,7397,6958,14355,
10,2580386,2519.908203,7459,6954,14413,
10,2594760,2533.945313,7474,7004,14478,
10,2609158,2548.005859,7398,6928,14326,
10,2623532,2562.042969,7334,6886,14220,
10,2637908,2576.082031,7395,6924,14319,
10,2652276,2590.113281,7366,6922,14288,BAn20m15 (iteration 4)
10,15178,14.82226563,108,73,181,
10,29562,28.86914063,115,75,190,
10,43956,42.92578125,115,78,193,
10,58330,56.96289063,112,76,188,
10,72704,71,115,76,191,
10,87070,85.02929688,115,75,190,
10,101442,99.06445313,125,84,209,
10,115814,113.0996094,130,89,219,
10,130194,127.1425781,116,66,182,
10,144564,141.1757813,138,94,232,
10,158950,155.2246094,146,95,241,
10,173320,169.2578125,306,203,509,
10,187708,183.3085938,145,100,245,
10,202080,197.34375,135,88,223,
10,216468,211.3945313,144,89,233,
10,230848,225.4375,124,72,196,
10,245238,239.4902344,147,72,219,
10,259620,253.5351563,137,83,220,
10,273998,267.5761719,137,85,222,
10,288362,281.6035156,131,73,204,
10,302728,295.6328125,17151,17090,34241,
10,317094,309.6621094,2199,2122,4321,
10,331464,323.6953125,1208,1140,2348,
10,345846,337.7402344,883,817,1700,
10,360232,351.7890625,807,731,1538,
10,374616,365.8359375,1232,1160,2392,
10,389000,379.8828125,457,382,839,
10,403370,393.9160156,1293,1215,2508,
10,417736,407.9453125,1320,1238,2558,
10,432816,422.671875,596,518,1114,
10,447892,437.3945313,670,590,1260,
10,462954,452.1035156,725,622,1347,
10,478034,466.8300781,532,453,985,
10,493116,481.5585938,639,518,1157,
10,508190,496.2792969,685,604,1289,
10,523264,511,597,520,1117,
10,538336,525.71875,654,566,1220,
10,553422,540.4511719,617,531,1148,
10,568502,555.1777344,711,629,1340,
10,583574,569.8964844,748,623,1371,
10,598648,584.6171875,647,546,1193,
10,613728,599.34375,595,504,1099,
10,628804,614.0664063,1524,1388,2912,
10,643878,628.7871094,1245,1123,2368,
10,658944,643.5,1218,1112,2330,
10,674012,658.2148438,1314,1207,2521,
10,689088,672.9375,1343,1208,2551,
10,704172,687.6679688,1438,1307,2745,
10,719250,702.3925781,1354,1245,2599,
10,734330,717.1191406,1180,1060,2240,
10,749416,731.8515625,1661,1529,3190,
10,764508,746.5898438,1178,1060,2238,
10,779600,761.328125,1279,1165,2444,
10,794690,776.0644531,1514,1402,2916,
10,809768,790.7890625,1546,1429,2975,
10,824840,805.5078125,1224,1110,2334,
10,839910,820.2246094,1140,1010,2150,
10,854992,834.953125,1272,1147,2419,
10,870058,849.6660156,1241,1130,2371,
10,885136,864.390625,1311,1191,2502,
10,900220,879.1210938,1289,1158,2447,
10,915292,893.8398438,1294,1172,2466,
10,930356,908.5507813,1961,1831,3792,
10,945442,923.2832031,1824,1690,3514,
10,960528,938.015625,1677,1549,3226,
10,975604,952.7382813,1790,1627,3417,
10,990708,967.4882813,1794,1639,3433,
10,1005776,982.203125,2183,2039,4222,
10,1020852,996.9257813,2159,2017,4176,
10,1035942,1011.662109,2209,2007,4216,
10,1051018,1026.384766,2155,2003,4158,
10,1066100,1041.113281,2138,2001,4139,
10,1081160,1055.820313,2191,2028,4219,
10,1096230,1070.537109,2415,2247,4662,
10,1111308,1085.261719,2250,2083,4333,
10,1126386,1099.986328,2276,2059,4335,
10,1141466,1114.712891,2364,2212,4576,
10,1156540,1129.433594,2249,1854,4103,
10,1171620,1144.160156,2280,2120,4400,
10,1186702,1158.888672,2563,1286,3849,
10,1201780,1173.613281,2427,2267,4694,
10,1216846,1188.326172,3275,1336,4611,
10,1231918,1203.044922,2984,2746,5730,
10,1246994,1217.767578,2501,2314,4815,
10,1262086,1232.505859,2782,2554,5336,
10,1277158,1247.224609,2635,2464,5099,
10,1292230,1261.943359,2863,2675,5538,
10,1307320,1276.679688,2791,2618,5409,
10,1322402,1291.408203,2914,2729,5643,
10,1337480,1306.132813,3241,3031,6272,
10,1352568,1320.867188,3211,3027,6238,
10,1367648,1335.59375,3364,3160,6524,
10,1382736,1350.328125,3251,3027,6278,
10,1397820,1365.058594,3464,3244,6708,
10,1412900,1379.785156,3430,3246,6676,
10,1427996,1394.527344,3372,3120,6492,
10,1443080,1409.257813,3404,3182,6586,
10,1458164,1423.988281,3384,3160,6544,
10,1473240,1438.710938,3372,3163,6535,
10,1488308,1453.425781,3651,3398,7049,
10,1503376,1468.140625,3439,3222,6661,
10,1518456,1482.867188,3480,3267,6747,
10,1533524,1497.582031,4772,4545,9317,
10,1548594,1512.298828,3949,3706,7655,
10,1563674,1527.025391,3944,3742,7686,
10,1578738,1541.736328,3967,3683,7650,
10,1593830,1556.474609,3942,3706,7648,
10,1608908,1571.199219,4061,3815,7876,
10,1623986,1585.923828,3967,3698,7665,
10,1639062,1600.646484,3974,3693,7667,
10,1654142,1615.373047,4410,2958,7368,
10,1669222,1630.099609,4585,4134,8719,
10,1684290,1644.814453,4767,4493,9260,
10,1699376,1659.546875,4682,4432,9114,
10,1714450,1674.267578,4242,3789,8031,
10,1729530,1688.994141,4142,3862,8004,
10,1744596,1703.707031,4217,3945,8162,
10,1759670,1718.427734,4271,3949,8220,
10,1774762,1733.166016,4227,3914,8141,
10,1789850,1747.900391,4331,3995,8326,
10,1804216,1761.929688,5560,2666,8226,
10,1818596,1775.972656,5022,4688,9710,
10,1832950,1789.990234,4921,3740,8661,
10,1847344,1804.046875,5430,4042,9472,
10,1861716,1818.082031,4903,4596,9499,
10,1876090,1832.119141,5140,4319,9459,
10,1890488,1846.179688,4966,4666,9632,
10,1904854,1860.208984,5031,4605,9636,
10,1919222,1874.240234,4916,4638,9554,
10,1933586,1888.267578,4961,4663,9624,
10,1947960,1902.304688,4980,4689,9669,
10,1962336,1916.34375,5062,4782,9844,
10,1976708,1930.378906,4995,4692,9687,
10,1991094,1944.427734,6793,6478,13271,
10,2005464,1958.460938,6286,5997,12283,
10,2019822,1972.482422,6434,5878,12312,
10,2034194,1986.517578,6388,6052,12440,
10,2048572,2000.558594,6404,6050,12454,
10,2062950,2014.599609,6227,5899,12126,
10,2077314,2028.626953,6602,6280,12882,
10,2091686,2042.662109,6345,5997,12342,
10,2106052,2056.691406,6424,6045,12469,
10,2120420,2070.722656,6449,6114,12563,
10,2134798,2084.763672,6345,6016,12361,
10,2149182,2098.810547,6600,6247,12847,
10,2163560,2112.851563,6496,6168,12664,
10,2177942,2126.896484,6440,6078,12518,
10,2192324,2140.941406,6465,6101,12566,
10,2206706,2154.986328,6569,6187,12756,
10,2221090,2169.033203,6564,6213,12777,
10,2235474,2183.080078,6507,6058,12565,
10,2249856,2197.125,6549,6159,12708,
10,2264214,2211.146484,6622,6211,12833,
10,2278592,2225.1875,6579,6170,12749,
10,2292970,2239.228516,6468,6081,12549,
10,2307352,2253.273438,6509,6151,12660,
10,2321732,2267.316406,7829,7408,15237,
10,2336112,2281.359375,7914,7548,15462,
10,2350464,2295.375,8070,7704,15774,
10,2364860,2309.433594,8947,8566,17513,
10,2379232,2323.46875,8329,7862,16191,
10,2393606,2337.505859,8039,7618,15657,
10,2407986,2351.548828,8066,7568,15634,
10,2422366,2365.591797,8157,7760,15917,
10,2436722,2379.611328,8145,7720,15865,
10,2451106,2393.658203,7302,6778,14080,
10,2465468,2407.683594,7336,6852,14188,
10,2479842,2421.720703,7262,6772,14034,
10,2494222,2435.763672,7406,6950,14356,
10,2508592,2449.796875,7173,6778,13951,
10,2522974,2463.841797,7266,6802,14068,
10,2537348,2477.878906,7420,7002,14422,
10,2551740,2491.933594,7311,6867,14178,
10,2566116,2505.972656,7357,6910,14267,
10,2580482,2520.001953,7397,6945,14342,
10,2594858,2534.041016,7212,6772,13984,
10,2609234,2548.080078,7596,7115,14711,
10,2623612,2562.121094,7462,6995,14457,
10,2637998,2576.169922,7842,7375,15217,
10,2652370,2590.205078,7425,6958,14383,BAn20m15 (iteration 5)
