Size of Data  (KB),Server Data Size,Server Data Size (KB),Time to Send,Time to Receive,Processing Time,Topology,
3,4656,4.546875,91,40,131,,
3,8536,8.3359375,100,16,116,,
3,12416,12.125,88,37,125,,
3,16294,15.91210938,72,25,97,,
3,20170,19.69726563,85,30,115,,
3,24036,23.47265625,68,22,90,,
3,27924,27.26953125,77,49,126,,
3,31784,31.0390625,84,37,121,,
3,35666,34.83007813,100,40,140,,
3,39556,38.62890625,100,41,141,,
3,43436,42.41796875,102,35,137,,
3,47310,46.20117188,72,41,113,,
3,51180,49.98046875,66,18,84,,
3,55066,53.77539063,77,41,118,,
3,58940,57.55859375,80,34,114,,
3,62806,61.33398438,72,21,93,,
3,66684,65.12109375,110,44,154,,
3,70566,68.91210938,76,18,94,,
3,74456,72.7109375,88,34,122,,
3,78318,76.48242188,84,23,107,,
3,82192,80.265625,80,18,98,,
3,86056,84.0390625,91,53,144,,
3,89928,87.8203125,93,41,134,,
3,93800,91.6015625,104,34,138,,
3,97688,95.3984375,92,39,131,,
3,101562,99.18164063,92,18,110,,
3,105442,102.9707031,84,31,115,BAn15m2 (iteration 1),
3,4670,4.560546875,56,20,76,,
3,8542,8.341796875,67,20,87,,
3,12418,12.12695313,75,31,106,,
3,16290,15.90820313,82,49,131,,
3,20170,19.69726563,91,26,117,,
3,24050,23.48632813,79,32,111,,
3,27934,27.27929688,101,47,148,,
3,31814,31.06835938,78,19,97,,
3,35694,34.85742188,93,41,134,,
3,39562,38.63476563,93,38,131,,
3,43454,42.43554688,92,34,126,,
3,47336,46.2265625,91,32,123,,
3,51212,50.01171875,85,28,113,,
3,55096,53.8046875,102,42,144,,
3,58980,57.59765625,118,44,162,,
3,62866,61.39257813,147,72,219,,
3,66754,65.18945313,112,39,151,,
3,70632,68.9765625,114,41,155,,
3,74512,72.765625,105,33,138,,
3,78392,76.5546875,84,18,102,,
3,82266,80.33789063,86,36,122,,
3,86130,84.11132813,80,39,119,,
3,90010,87.90039063,97,34,131,,
3,93880,91.6796875,111,40,151,,
3,97768,95.4765625,91,23,114,,
3,101642,99.25976563,82,36,118,,
3,105518,103.0449219,95,38,133,BAn15m2 (iteration 2),
3,4656,4.546875,92,19,111,,
3,8536,8.3359375,85,24,109,,
3,12416,12.125,92,32,124,,
3,16294,15.91210938,79,25,104,,
3,20170,19.69726563,104,33,137,,
3,24036,23.47265625,102,29,131,,
3,27924,27.26953125,97,36,133,,
3,31784,31.0390625,95,38,133,,
3,35666,34.83007813,114,33,147,,
3,39556,38.62890625,207,141,348,,
3,43436,42.41796875,116,45,161,,
3,47310,46.20117188,96,21,117,,
3,51180,49.98046875,116,49,165,,
3,55066,53.77539063,97,31,128,,
3,58940,57.55859375,99,34,133,,
3,62806,61.33398438,114,56,170,,
3,66684,65.12109375,139,48,187,,
3,70566,68.91210938,117,38,155,,
3,74456,72.7109375,238,92,330,,
3,78318,76.48242188,650,543,1193,,
3,82192,80.265625,133,18,151,,
3,86056,84.0390625,96,23,119,,
3,89928,87.8203125,131,61,192,,
3,93800,91.6015625,152,44,196,,
3,97688,95.3984375,101,33,134,,
3,101562,99.18164063,172,54,226,,
3,105442,102.9707031,122,47,169,BAn15m2 (iteration 3),
3,4672,4.5625,68,36,104,,
3,8558,8.357421875,64,19,83,,
3,12432,12.140625,68,37,105,,
3,16308,15.92578125,66,36,102,,
3,20182,19.70898438,58,21,79,,
3,24058,23.49414063,66,36,102,,
3,27946,27.29101563,69,22,91,,
3,31836,31.08984375,58,30,88,,
3,35720,34.8828125,55,22,77,,
3,39588,38.66015625,123,35,158,,
3,43460,42.44140625,66,40,106,,
3,47332,46.22265625,109,35,144,,
3,51208,50.0078125,83,34,117,,
3,55076,53.78515625,98,29,127,,
3,58954,57.57226563,84,27,111,,
3,62850,61.37695313,75,25,100,,
3,66734,65.16992188,84,36,120,,
3,70622,68.96679688,74,29,103,,
3,74498,72.75195313,70,27,97,,
3,78380,76.54296875,66,20,86,,
3,82262,80.33398438,116,38,154,,
3,86152,84.1328125,92,39,131,,
3,90036,87.92578125,101,26,127,,
3,93898,91.69726563,77,42,119,,
3,97776,95.484375,69,27,96,,
3,101662,99.27929688,81,28,109,,
3,105548,103.0742188,82,18,100,BAn15m2 (iteration 4),
3,4680,4.5703125,57,19,76,,
3,8552,8.3515625,63,19,82,,
3,12422,12.13085938,57,23,80,,
3,16278,15.89648438,67,38,105,,
3,20146,19.67382813,81,19,100,,
3,24014,23.45117188,91,20,111,,
3,27896,27.2421875,60,22,82,,
3,31774,31.02929688,163,35,198,,
3,35650,34.81445313,63,37,100,,
3,39526,38.59960938,65,23,88,,
3,43408,42.390625,56,18,74,,
3,47272,46.1640625,65,18,83,,
3,51152,49.953125,68,18,86,,
3,55030,53.74023438,76,38,114,,
3,58914,57.53320313,73,26,99,,
3,62784,61.3125,92,55,147,,
3,66662,65.09960938,78,28,106,,
3,70538,68.88476563,57,29,86,,
3,74422,72.67773438,79,18,97,,
3,78300,76.46484375,71,29,100,,
3,82174,80.24804688,59,31,90,,
3,86052,84.03515625,86,35,121,,
3,89922,87.81445313,74,26,100,,
3,93778,91.58007813,76,29,105,,
3,97658,95.36914063,72,26,98,,
3,101530,99.15039063,71,17,88,,
3,105410,102.9394531,113,62,175,BAn15m2 (iteration 5),
3,4658,4.548828125,65,32,97,,
3,8530,8.330078125,60,20,80,,
3,12400,12.109375,57,20,77,,
3,16268,15.88671875,57,30,87,,
3,20140,19.66796875,89,18,107,,
3,24020,23.45703125,179,24,203,,
3,27888,27.234375,60,29,89,,
3,31770,31.02539063,55,29,84,,
3,35642,34.80664063,55,23,78,,
3,39520,38.59375,63,38,101,,
3,43408,42.390625,62,19,81,,
3,47286,46.17773438,69,25,94,,
3,51160,49.9609375,64,24,88,,
3,55014,53.72460938,65,25,90,,
3,58882,57.50195313,68,26,94,,
3,62750,61.27929688,73,26,99,,
3,66622,65.06054688,99,58,157,,
3,70502,68.84960938,58,30,88,,
3,74390,72.64648438,92,42,134,,
3,78268,76.43359375,60,17,77,,
3,82140,80.21484375,65,29,94,,
3,86020,84.00390625,77,44,121,,
3,89898,87.79101563,96,33,129,,
3,93782,91.58398438,85,31,116,,
3,97658,95.36914063,80,29,109,,
3,101538,99.15820313,72,24,96,,
3,105418,102.9472656,100,40,140,,
3,109284,106.7226563,84,34,118,,
3,113152,110.5,86,32,118,,
3,117020,114.2773438,73,14,87,,
3,120890,118.0566406,77,18,95,,
3,124752,121.828125,73,19,92,,
3,128634,125.6191406,86,32,118,,
3,132516,129.4101563,84,34,118,,
3,136380,133.1835938,63,16,79,,
3,140254,136.9667969,82,24,106,,
3,144132,140.7539063,101,33,134,,
3,148016,144.546875,100,37,137,,
3,151894,148.3339844,93,22,115,BAn15m3 (iteration 1),
3,4664,4.5546875,58,24,82,,
3,8544,8.34375,75,27,102,,
3,12426,12.13476563,66,22,88,,
3,16302,15.91992188,84,23,107,,
3,20184,19.7109375,152,122,274,,
3,24050,23.48632813,227,35,262,,
3,27934,27.27929688,186,34,220,,
3,31810,31.06445313,64,28,92,,
3,35684,34.84765625,79,34,113,,
3,39560,38.6328125,64,25,89,,
3,43428,42.41015625,87,38,125,,
3,47306,46.19726563,83,37,120,,
3,51186,49.98632813,178,33,211,,
3,55056,53.765625,62,21,83,,
3,58938,57.55664063,64,24,88,,
3,62822,61.34960938,125,26,151,,
3,66688,65.125,57,19,76,,
3,70550,68.89648438,63,36,99,,
3,74422,72.67773438,160,24,184,,
3,78318,76.48242188,68,40,108,,
3,82188,80.26171875,77,17,94,,
3,86070,84.05273438,168,13,181,,
3,89938,87.83007813,58,31,89,,
3,93820,91.62109375,62,31,93,,
3,97696,95.40625,169,48,217,,
3,101568,99.1875,69,33,102,,
3,105446,102.9746094,89,33,122,,
3,109314,106.7519531,168,32,200,,
3,113196,110.5429688,76,48,124,,
3,117070,114.3261719,80,21,101,,
3,120948,118.1132813,205,29,234,,
3,124832,121.90625,73,24,97,,
3,128710,125.6933594,76,20,96,,
3,132586,129.4785156,69,23,92,,
3,136468,133.2695313,70,26,96,,
3,140342,137.0527344,81,48,129,,
3,144206,140.8261719,78,26,104,,
3,148072,144.6015625,80,33,113,,
3,151960,148.3984375,72,37,109,BAn15m3 (iteration 2),
3,4660,4.55078125,62,24,86,,
3,8536,8.3359375,55,18,73,,
3,12404,12.11328125,83,35,118,,
3,16284,15.90234375,100,35,135,,
3,20160,19.6875,61,19,80,,
3,24034,23.47070313,67,26,93,,
3,27916,27.26171875,52,18,70,,
3,31798,31.05273438,54,20,74,,
3,35674,34.83789063,65,26,91,,
3,39566,38.63867188,51,28,79,,
3,43426,42.40820313,66,27,93,,
3,47296,46.1875,63,24,87,,
3,51192,49.9921875,77,31,108,,
3,55068,53.77734375,63,23,86,,
3,58948,57.56640625,64,26,90,,
3,62822,61.34960938,58,31,89,,
3,66698,65.13476563,55,20,75,,
3,70584,68.9296875,43,10,53,,
3,74468,72.72265625,59,20,79,,
3,78362,76.52539063,68,24,92,,
3,82234,80.30664063,67,41,108,,
3,86124,84.10546875,61,22,83,,
3,89998,87.88867188,79,33,112,,
3,93858,91.65820313,66,40,106,,
3,97716,95.42578125,77,37,114,,
3,101600,99.21875,56,14,70,,
3,105486,103.0136719,70,37,107,,
3,109370,106.8066406,67,39,106,,
3,113234,110.5800781,83,18,101,,
3,117090,114.3457031,85,32,117,,
3,120968,118.1328125,79,23,102,,
3,124852,121.9257813,88,42,130,,
3,128738,125.7207031,88,39,127,,
3,132606,129.4980469,70,25,95,,
3,136472,133.2734375,80,29,109,,
3,140334,137.0449219,93,21,114,,
3,144204,140.8242188,67,16,83,,
3,148074,144.6035156,203,158,361,,
3,151946,148.3847656,79,48,127,BAn15m3 (iteration 3),
3,4656,4.546875,53,18,71,,
3,8536,8.3359375,51,18,69,,
3,12426,12.13476563,55,17,72,,
3,16302,15.91992188,75,37,112,,
3,20192,19.71875,52,30,82,,
3,24068,23.50390625,68,21,89,,
3,27942,27.28710938,53,19,72,,
3,31820,31.07421875,51,28,79,,
3,35698,34.86132813,62,24,86,,
3,39580,38.65234375,58,23,81,,
3,43458,42.43945313,60,23,83,,
3,47336,46.2265625,62,27,89,,
3,51218,50.01757813,63,37,100,,
3,55078,53.78710938,56,19,75,,
3,58960,57.578125,63,22,85,,
3,62826,61.35351563,58,17,75,,
3,66702,65.13867188,66,18,84,,
3,70586,68.93164063,55,21,76,,
3,74454,72.70898438,66,22,88,,
3,78314,76.47851563,66,24,90,,
3,82182,80.25585938,60,30,90,,
3,86074,84.05664063,70,42,112,,
3,89956,87.84765625,56,30,86,,
3,93832,91.6328125,78,17,95,,
3,97710,95.41992188,85,34,119,,
3,101572,99.19140625,92,24,116,,
3,105448,102.9765625,73,13,86,,
3,109332,106.7695313,64,38,102,,
3,113224,110.5703125,68,22,90,,
3,117096,114.3515625,69,24,93,,
3,120964,118.1289063,83,33,116,,
3,124854,121.9277344,73,26,99,,
3,128724,125.7070313,61,17,78,,
3,132616,129.5078125,407,356,763,,
3,136490,133.2910156,70,41,111,,
3,140364,137.0742188,69,27,96,,
3,144250,140.8691406,67,34,101,,
3,148126,144.6542969,84,34,118,,
3,152004,148.4414063,74,18,92,BAn15m3 (iteration 4),
3,4664,4.5546875,58,11,69,,
3,8550,8.349609375,53,15,68,,
3,12434,12.14257813,66,28,94,,
3,16316,15.93359375,79,50,129,,
3,20188,19.71484375,63,34,97,,
3,24062,23.49804688,78,36,114,,
3,27948,27.29296875,68,24,92,,
3,31834,31.08789063,44,23,67,,
3,35702,34.86523438,59,35,94,,
3,39576,38.6484375,56,31,87,,
3,43446,42.42773438,59,22,81,,
3,47320,46.2109375,52,30,82,,
3,51200,50,54,18,72,,
3,55078,53.78710938,52,26,78,,
3,58948,57.56640625,73,24,97,,
3,62814,61.34179688,53,17,70,,
3,66684,65.12109375,54,30,84,,
3,70552,68.8984375,75,38,113,,
3,74438,72.69335938,93,42,135,,
3,78320,76.484375,88,27,115,,
3,82196,80.26953125,58,31,89,,
3,86074,84.05664063,67,38,105,,
3,89954,87.84570313,56,30,86,,
3,93832,91.6328125,56,32,88,,
3,97706,95.41601563,60,18,78,,
3,101590,99.20898438,88,38,126,,
3,105470,102.9980469,66,18,84,,
3,109334,106.7714844,74,28,102,,
3,113208,110.5546875,73,29,102,,
3,117074,114.3300781,66,27,93,,
3,120974,118.1386719,75,27,102,,
3,124860,121.9335938,91,48,139,,
3,128736,125.71875,89,33,122,,
3,132610,129.5019531,255,192,447,,
3,136482,133.2832031,90,16,106,,
3,140356,137.0664063,68,22,90,,
3,144230,140.8496094,75,43,118,,
3,148122,144.6503906,76,28,104,,
3,151992,148.4296875,77,22,99,BAn15m3 (iteration 5),
3,4666,4.556640625,58,23,81,,
3,8544,8.34375,60,20,80,,
3,12416,12.125,52,16,68,,
3,16290,15.90820313,57,23,80,,
3,20176,19.703125,54,19,73,,
3,24056,23.4921875,63,20,83,,
3,27926,27.27148438,51,30,81,,
3,31802,31.05664063,85,36,121,,
3,35676,34.83984375,72,47,119,,
3,39548,38.62109375,61,23,84,,
3,43416,42.3984375,75,42,117,,
3,47308,46.19921875,61,32,93,,
3,51192,49.9921875,80,33,113,,
3,55068,53.77734375,57,21,78,,
3,58946,57.56445313,87,50,137,,
3,62826,61.35351563,57,21,78,,
3,66714,65.15039063,68,29,97,,
3,70588,68.93359375,83,33,116,,
3,74472,72.7265625,69,22,91,,
3,78356,76.51953125,68,27,95,,
3,82220,80.29296875,82,53,135,,
3,86088,84.0703125,61,32,93,,
3,89960,87.8515625,79,29,108,,
3,93840,91.640625,84,27,111,,
3,97726,95.43554688,73,43,116,,
3,101612,99.23046875,63,31,94,,
3,105492,103.0195313,66,26,92,,
3,109368,106.8046875,75,28,103,,
3,113244,110.5898438,76,26,102,,
3,117136,114.390625,60,17,77,,
3,121008,118.171875,62,18,80,,
3,124888,121.9609375,73,26,99,,
3,128780,125.7617188,63,18,81,,
3,132660,129.5507813,81,26,107,,
3,136538,133.3378906,92,33,125,,
3,140426,137.1347656,73,23,96,,
3,144302,140.9199219,84,34,118,,
3,148184,144.7109375,85,33,118,,
3,152060,148.4960938,76,18,94,,
3,155928,152.2734375,83,27,110,,
3,159810,156.0644531,90,29,119,,
3,163676,159.8398438,89,31,120,,
3,167566,163.6386719,88,31,119,,
3,171438,167.4199219,102,40,142,,
3,175312,171.203125,75,17,92,,
3,179200,175,89,31,120,,
3,183086,178.7949219,104,42,146,,
3,186976,182.59375,104,40,144,,
3,190844,186.3710938,108,34,142,,
3,194720,190.15625,107,34,141,,
3,198590,193.9355469,93,16,109,,
3,202474,197.7285156,301,242,543,,
3,206352,201.515625,98,32,130,,
3,210222,205.2949219,96,21,117,,
3,214098,209.0800781,658,581,1239,,
3,217982,212.8730469,907,852,1759,,
3,221844,216.6445313,100,33,133,,
3,225732,220.4414063,103,33,136,,
3,229596,224.2148438,107,40,147,,
3,233482,228.0097656,103,35,138,BAn15m5 (iteration 1),
3,4670,4.560546875,47,15,62,,
3,8552,8.3515625,61,11,72,,
3,12418,12.12695313,63,25,88,,
3,16300,15.91796875,58,19,77,,
3,20190,19.71679688,78,36,114,,
3,24060,23.49609375,72,33,105,,
3,27944,27.2890625,60,31,91,,
3,31822,31.07617188,42,22,64,,
3,35694,34.85742188,64,34,98,,
3,39568,38.640625,70,20,90,,
3,43446,42.42773438,70,28,98,,
3,47312,46.203125,84,35,119,,
3,51194,49.99414063,73,23,96,,
3,55072,53.78125,68,27,95,,
3,58956,57.57421875,55,30,85,,
3,62834,61.36132813,64,40,104,,
3,66696,65.1328125,62,18,80,,
3,70566,68.91210938,55,17,72,,
3,74444,72.69921875,77,33,110,,
3,78320,76.484375,66,21,87,,
3,82196,80.26953125,58,17,75,,
3,86072,84.0546875,67,20,87,,
3,89944,87.8359375,455,432,887,,
3,93826,91.62695313,73,41,114,,
3,97706,95.41601563,60,17,77,,
3,101578,99.19726563,64,18,82,,
3,105450,102.9785156,78,32,110,,
3,109324,106.7617188,73,30,103,,
3,113198,110.5449219,81,30,111,,
3,117068,114.3242188,80,35,115,,
3,120942,118.1074219,90,30,120,,
3,124816,121.890625,68,19,87,,
3,128684,125.6679688,88,29,117,,
3,132562,129.4550781,81,17,98,,
3,136432,133.234375,87,27,114,,
3,140316,137.0273438,76,20,96,,
3,144200,140.8203125,292,247,539,,
3,148076,144.6054688,83,34,117,,
3,151942,148.3808594,85,24,109,,
3,155828,152.1757813,84,23,107,,
3,159702,155.9589844,83,26,109,,
3,163578,159.7441406,87,26,113,,
3,167468,163.5429688,104,41,145,,
3,171358,167.3417969,100,24,124,,
3,175236,171.1289063,109,32,141,,
3,179116,174.9179688,99,18,117,,
3,182988,178.6992188,84,31,115,,
3,186858,182.4785156,85,31,116,,
3,190744,186.2734375,92,35,127,,
3,194624,190.0625,1421,1360,2781,,
3,198484,193.8320313,92,34,126,,
3,202360,197.6171875,107,33,140,,
3,206240,201.40625,243,166,409,,
3,210120,205.1953125,116,29,145,,
3,214004,208.9882813,115,31,146,,
3,217882,212.7753906,99,29,128,,
3,221778,216.5800781,101,25,126,,
3,225666,220.3769531,132,30,162,,
3,229536,224.15625,120,46,166,,
3,233412,227.9414063,113,17,130,BAn15m5 (iteration 2),
3,4664,4.5546875,55,23,78,,
3,8532,8.33203125,55,19,74,,
3,12416,12.125,52,23,75,,
3,16290,15.90820313,65,27,92,,
3,20176,19.703125,52,19,71,,
3,24056,23.4921875,63,26,89,,
3,27934,27.27929688,59,37,96,,
3,31804,31.05859375,72,27,99,,
3,35688,34.8515625,56,30,86,,
3,39556,38.62890625,65,29,94,,
3,43446,42.42773438,81,36,117,,
3,47324,46.21484375,75,35,110,,
3,51208,50.0078125,60,28,88,,
3,55094,53.80273438,76,30,106,,
3,58976,57.59375,63,25,88,,
3,62860,61.38671875,64,24,88,,
3,66738,65.17382813,60,23,83,,
3,70606,68.95117188,63,24,87,,
3,74488,72.7421875,49,17,66,,
3,78356,76.51953125,70,25,95,,
3,82232,80.3046875,62,36,98,,
3,86110,84.09179688,352,297,649,,
3,89998,87.88867188,56,17,73,,
3,93886,91.68554688,55,30,85,,
3,97770,95.47851563,67,41,108,,
3,101654,99.27148438,59,32,91,,
3,105526,103.0527344,94,18,112,,
3,109410,106.8457031,85,38,123,,
3,113276,110.6210938,69,31,100,,
3,117150,114.4042969,73,13,86,,
3,121040,118.203125,79,50,129,,
3,124922,121.9941406,73,41,114,,
3,128782,125.7636719,79,31,110,,
3,132674,129.5644531,98,41,139,,
3,136560,133.359375,89,33,122,,
3,140436,137.1445313,111,45,156,,
3,144306,140.9238281,104,37,141,,
3,148174,144.7011719,76,16,92,,
3,152052,148.4882813,90,17,107,,
3,155934,152.2792969,74,19,93,,
3,159814,156.0683594,780,719,1499,,
3,163694,159.8574219,73,17,90,,
3,167566,163.6386719,71,17,88,,
3,171458,167.4394531,85,18,103,,
3,175324,171.2148438,84,34,118,,
3,179206,175.0058594,64,17,81,,
3,183082,178.7910156,78,29,107,,
3,186970,182.5878906,69,21,90,,
3,190858,186.3847656,519,488,1007,,
3,194728,190.1640625,96,33,129,,
3,198592,193.9375,874,797,1671,,
3,202478,197.7324219,95,25,120,,
3,206358,201.5214844,106,30,136,,
3,210246,205.3183594,157,48,205,,
3,214126,209.1074219,100,42,142,,
3,218004,212.8945313,463,378,841,,
3,221880,216.6796875,122,36,158,,
3,225754,220.4628906,111,51,162,,
3,229622,224.2402344,91,32,123,,
3,233508,228.0351563,114,45,159,BAn15m5 (iteration 3),
3,4662,4.552734375,67,20,87,,
3,8546,8.345703125,60,18,78,,
3,12420,12.12890625,67,29,96,,
3,16300,15.91796875,65,25,90,,
3,20180,19.70703125,68,27,95,,
3,24062,23.49804688,59,24,83,,
3,27940,27.28515625,64,23,87,,
3,31820,31.07421875,80,31,111,,
3,35696,34.859375,84,37,121,,
3,39570,38.64257813,86,37,123,,
3,43444,42.42578125,64,19,83,,
3,47336,46.2265625,52,29,81,,
3,51216,50.015625,74,26,100,,
3,55098,53.80664063,55,27,82,,
3,58982,57.59960938,65,33,98,,
3,62850,61.37695313,70,29,99,,
3,66728,65.1640625,89,33,122,,
3,70592,68.9375,86,40,126,,
3,74470,72.72460938,69,25,94,,
3,78354,76.51757813,59,17,76,,
3,82232,80.3046875,65,26,91,,
3,86112,84.09375,57,31,88,,
3,89990,87.88085938,70,33,103,,
3,93882,91.68164063,76,39,115,,
3,97764,95.47265625,89,32,121,,
3,101638,99.25585938,277,241,518,,
3,105512,103.0390625,66,22,88,,
3,109382,106.8183594,65,21,86,,
3,113254,110.5996094,91,43,134,,
3,117132,114.3867188,84,25,109,,
3,121006,118.1699219,87,36,123,,
3,124884,121.9570313,78,37,115,,
3,128754,125.7363281,74,30,104,,
3,132628,129.5195313,78,28,106,,
3,136498,133.2988281,76,26,102,,
3,140362,137.0722656,93,32,125,,
3,144242,140.8613281,70,16,86,,
3,148118,144.6464844,66,17,83,,
3,152004,148.4414063,76,34,110,,
3,155878,152.2246094,76,30,106,,
3,159744,156,84,19,103,,
3,163616,159.78125,84,33,117,,
3,167474,163.5488281,70,22,92,,
3,171348,167.3320313,76,30,106,,
3,175228,171.1210938,85,39,124,,
3,179104,174.90625,88,38,126,,
3,182988,178.6992188,93,28,121,,
3,186858,182.4785156,103,29,132,,
3,190742,186.2714844,1048,985,2033,,
3,194624,190.0625,120,33,153,,
3,198494,193.8417969,108,35,143,,
3,202370,197.6269531,108,36,144,,
3,206244,201.4101563,100,40,140,,
3,210102,205.1777344,647,598,1245,,
3,213978,208.9628906,67,18,85,,
3,217854,212.7480469,78,25,103,,
3,221724,216.5273438,93,35,128,,
3,225616,220.328125,85,33,118,,
3,229488,224.109375,97,34,131,,
3,233374,227.9042969,93,32,125,BAn15m5 (iteration 4),
3,4664,4.5546875,75,37,112,,
3,8550,8.349609375,63,24,87,,
3,12430,12.13867188,54,19,73,,
3,16304,15.921875,68,16,84,,
3,20178,19.70507813,52,19,71,,
3,24072,23.5078125,87,21,108,,
3,27940,27.28515625,80,36,116,,
3,31816,31.0703125,86,33,119,,
3,35686,34.84960938,78,37,115,,
3,39554,38.62695313,90,35,125,,
3,43426,42.40820313,65,22,87,,
3,47308,46.19921875,84,35,119,,
3,51180,49.98046875,81,29,110,,
3,55046,53.75585938,52,28,80,,
3,58920,57.5390625,61,21,82,,
3,62810,61.33789063,64,23,87,,
3,66688,65.125,62,25,87,,
3,70570,68.91601563,72,33,105,,
3,74442,72.69726563,63,25,88,,
3,78318,76.48242188,77,32,109,,
3,82202,80.27539063,81,33,114,,
3,86088,84.0703125,77,33,110,,
3,89972,87.86328125,79,37,116,,
3,93850,91.65039063,82,28,110,,
3,97712,95.421875,73,29,102,,
3,101584,99.203125,83,31,114,,
3,105472,103,78,29,107,,
3,109362,106.7988281,84,32,116,,
3,113240,110.5859375,84,33,117,,
3,117128,114.3828125,60,16,76,,
3,120994,118.1582031,66,22,88,,
3,124872,121.9453125,57,31,88,,
3,128754,125.7363281,66,29,95,,
3,132638,129.5292969,264,214,478,,
3,136508,133.3085938,64,16,80,,
3,140378,137.0878906,87,29,116,,
3,144250,140.8691406,61,19,80,,
3,148118,144.6464844,64,32,96,,
3,152000,148.4375,57,28,85,,
3,155876,152.2226563,66,22,88,,
3,159758,156.0136719,66,20,86,,
3,163640,159.8046875,68,19,87,,
3,167510,163.5839844,86,29,115,,
3,171376,167.359375,84,37,121,,
3,175258,171.1503906,75,27,102,,
3,179142,174.9433594,85,17,102,,
3,183018,178.7285156,354,290,644,,
3,186910,182.5292969,88,24,112,,
3,190780,186.3085938,92,39,131,,
3,194652,190.0898438,81,32,113,,
3,198528,193.875,70,21,91,,
3,202394,197.6503906,766,731,1497,,
3,206274,201.4394531,105,33,138,,
3,210162,205.2363281,103,40,143,,
3,214054,209.0371094,103,35,138,,
3,217926,212.8183594,88,33,121,,
3,221808,216.609375,88,32,120,,
3,225690,220.4003906,84,32,116,,
3,229566,224.1855469,86,17,103,,
3,233444,227.9726563,92,36,128,BAn15m5 (iteration 5),
3,4678,4.568359375,65,36,101,,
3,8560,8.359375,59,20,79,,
3,12432,12.140625,49,19,68,,
3,16304,15.921875,56,24,80,,
3,20172,19.69921875,56,23,79,,
3,24036,23.47265625,55,24,79,,
3,27914,27.25976563,60,24,84,,
3,31802,31.05664063,51,29,80,,
3,35678,34.84179688,67,38,105,,
3,39544,38.6171875,59,35,94,,
3,43414,42.39648438,57,34,91,,
3,47296,46.1875,49,30,79,,
3,51190,49.99023438,58,24,82,,
3,55062,53.77148438,62,19,81,,
3,58934,57.55273438,86,44,130,,
3,62802,61.33007813,65,29,94,,
3,66668,65.10546875,74,39,113,,
3,70548,68.89453125,69,38,107,,
3,74422,72.67773438,65,22,87,,
3,78282,76.44726563,99,28,127,,
3,82156,80.23046875,69,26,95,,
3,86036,84.01953125,71,26,97,,
3,89902,87.79492188,85,38,123,,
3,93766,91.56835938,87,39,126,,
3,97654,95.36523438,86,36,122,,
3,101528,99.1484375,525,489,1014,,
3,105414,102.9433594,58,17,75,,
3,109300,106.7382813,67,33,100,,
3,113182,110.5292969,61,15,76,,
3,117050,114.3066406,84,26,110,,
3,120920,118.0859375,74,25,99,,
3,124794,121.8691406,69,28,97,,
3,128684,125.6679688,80,18,98,,
3,132562,129.4550781,65,25,90,,
3,136432,133.234375,69,39,108,,
3,140322,137.0332031,78,45,123,,
3,144194,140.8144531,60,16,76,,
3,148068,144.5976563,66,16,82,,
3,151930,148.3691406,84,33,117,,
3,155810,152.1582031,85,33,118,,
3,159688,155.9453125,73,40,113,,
3,163566,159.7324219,70,23,93,,
3,167448,163.5234375,74,26,100,,
3,171312,167.296875,76,41,117,,
3,175186,171.0800781,69,22,91,,
3,179048,174.8515625,74,24,98,,
3,182940,178.6523438,66,19,85,,
3,186826,182.4472656,67,20,87,,
3,190712,186.2421875,77,28,105,,
3,194584,190.0234375,285,225,510,,
3,198464,193.8125,81,30,111,,
3,202348,197.6054688,74,20,94,,
3,206222,201.3886719,100,34,134,,
3,210090,205.1660156,89,36,125,,
3,213958,208.9433594,87,17,104,,
3,217842,212.7363281,76,31,107,,
3,221720,216.5234375,1495,1457,2952,,
3,225598,220.3105469,112,44,156,,
3,229468,224.0898438,84,29,113,,
3,233354,227.8847656,92,35,127,,
3,237240,231.6796875,84,28,112,,
3,241114,235.4628906,80,22,102,,
3,244988,239.2460938,89,32,121,,
3,248866,243.0332031,522,458,980,,
3,252742,246.8183594,96,20,116,,
3,256632,250.6171875,80,21,101,,
3,260506,254.4003906,236,178,414,,
3,264392,258.1953125,107,20,127,,
3,268276,261.9882813,87,33,120,,
3,272152,265.7734375,88,33,121,,
3,276030,269.5605469,1633,1567,3200,,
3,279888,273.328125,94,17,111,,
3,283764,277.1132813,91,33,124,,
3,287636,280.8945313,101,40,141,,
3,291508,284.6757813,99,34,133,,
3,295384,288.4609375,114,42,156,,
3,299250,292.2363281,118,42,160,BAn15m7 (iteration 1),
3,4660,4.55078125,66,35,101,,
3,8540,8.33984375,53,19,72,,
3,12408,12.1171875,56,23,79,,
3,16290,15.90820313,45,16,61,,
3,20160,19.6875,60,26,86,,
3,24036,23.47265625,66,34,100,,
3,27916,27.26171875,51,19,70,,
3,31788,31.04296875,76,42,118,,
3,35666,34.83007813,79,39,118,,
3,39546,38.61914063,69,40,109,,
3,43422,42.40429688,79,51,130,,
3,47292,46.18359375,62,18,80,,
3,51174,49.97460938,64,22,86,,
3,55034,53.74414063,57,21,78,,
3,58912,57.53125,58,22,80,,
3,62776,61.3046875,48,16,64,,
3,66652,65.08984375,50,17,67,,
3,70520,68.8671875,52,17,69,,
3,74422,72.67773438,62,37,99,,
3,78316,76.48046875,64,25,89,,
3,82204,80.27734375,76,29,105,,
3,86064,84.046875,58,31,89,,
3,89936,87.828125,60,31,91,,
3,93826,91.62695313,78,36,114,,
3,97702,95.41210938,77,29,106,,
3,101578,99.19726563,921,870,1791,,
3,105454,102.9824219,123,72,195,,
3,109332,106.7695313,85,35,120,,
3,113190,110.5371094,80,35,115,,
3,117072,114.328125,70,25,95,,
3,120956,118.1210938,79,31,110,,
3,124830,121.9042969,73,29,102,,
3,128712,125.6953125,71,29,100,,
3,132596,129.4882813,66,26,92,,
3,136466,133.2675781,69,24,93,,
3,140350,137.0605469,60,29,89,,
3,144232,140.8515625,73,44,117,,
3,148100,144.6289063,72,29,101,,
3,151990,148.4277344,61,32,93,,
3,155852,152.1992188,84,29,113,,
3,159710,155.9667969,89,38,127,,
3,163586,159.7519531,75,32,107,,
3,167478,163.5527344,90,31,121,,
3,171348,167.3320313,91,41,132,,
3,175226,171.1191406,84,28,112,,
3,179094,174.8964844,86,37,123,,
3,182972,178.6835938,93,34,127,,
3,186834,182.4550781,72,17,89,,
3,190712,186.2421875,67,17,84,,
3,194596,190.0351563,88,39,127,,
3,198478,193.8261719,401,347,748,,
3,202346,197.6035156,103,38,141,,
3,206228,201.3945313,105,40,145,,
3,210098,205.1738281,164,98,262,,
3,213976,208.9609375,84,31,115,,
3,217872,212.765625,84,32,116,,
3,221742,216.5449219,1210,1151,2361,,
3,225626,220.3378906,75,17,92,,
3,229500,224.1210938,86,18,104,,
3,233368,227.8984375,94,32,126,,
3,237244,231.6835938,84,30,114,,
3,241114,235.4628906,85,30,115,,
3,244992,239.25,73,25,98,,
3,248856,243.0234375,88,32,120,,
3,252730,246.8066406,76,21,97,,
3,256610,250.5957031,86,34,120,,
3,260484,254.3789063,77,21,98,,
3,264332,258.1367188,363,291,654,,
3,268212,261.9257813,94,36,130,,
3,272096,265.71875,101,38,139,,
3,275982,269.5136719,111,35,146,,
3,279860,273.3007813,2465,2377,4842,,
3,283738,277.0878906,126,34,160,,
3,287622,280.8808594,126,23,149,,
3,291508,284.6757813,111,33,144,,
3,295380,288.4570313,91,17,108,,
3,299244,292.2304688,88,33,121,BAn15m7 (iteration 2),
3,4660,4.55078125,76,36,112,,
3,8524,8.32421875,95,37,132,,
3,12394,12.10351563,80,35,115,,
3,16272,15.890625,58,18,76,,
3,20152,19.6796875,58,23,81,,
3,24016,23.453125,49,19,68,,
3,27888,27.234375,57,34,91,,
3,31764,31.01953125,55,30,85,,
3,35634,34.79882813,51,30,81,,
3,39504,38.578125,71,41,112,,
3,43380,42.36328125,52,24,76,,
3,47258,46.15039063,63,37,100,,
3,51130,49.93164063,67,26,93,,
3,55004,53.71484375,71,30,101,,
3,58880,57.5,54,23,77,,
3,62768,61.296875,57,23,80,,
3,66640,65.078125,54,34,88,,
3,70514,68.86132813,79,38,117,,
3,74398,72.65429688,58,16,74,,
3,78254,76.41992188,79,34,113,,
3,82136,80.2109375,62,19,81,,
3,86018,84.00195313,64,21,85,,
3,89884,87.77734375,76,30,106,,
3,93760,91.5625,69,36,105,,
3,97634,95.34570313,899,849,1748,,
3,101498,99.11914063,79,38,117,,
3,105380,102.9101563,80,36,116,,
3,109254,106.6933594,56,18,74,,
3,113126,110.4746094,57,32,89,,
3,117008,114.265625,65,28,93,,
3,120882,118.0488281,61,33,94,,
3,124754,121.8300781,58,16,74,,
3,128652,125.6367188,70,25,95,,
3,132522,129.4160156,81,28,109,,
3,136398,133.2011719,60,32,92,,
3,140268,136.9804688,85,55,140,,
3,144162,140.7832031,84,35,119,,
3,148052,144.5820313,71,27,98,,
3,151930,148.3691406,64,16,80,,
3,155802,152.1503906,63,17,80,,
3,159670,155.9277344,59,17,76,,
3,163536,159.703125,72,39,111,,
3,167406,163.4824219,84,36,120,,
3,171274,167.2597656,84,32,116,,
3,175148,171.0429688,78,29,107,,
3,179024,174.828125,83,49,132,,
3,182888,178.6015625,65,17,82,,
3,186774,182.3964844,77,28,105,,
3,190654,186.1855469,1067,1020,2087,,
3,194522,189.9628906,76,33,109,,
3,198398,193.7480469,86,26,112,,
3,202268,197.5273438,82,31,113,,
3,206134,201.3027344,95,32,127,,
3,210022,205.0996094,105,33,138,,
3,213904,208.890625,116,40,156,,
3,217788,212.6835938,86,17,103,,
3,221666,216.4707031,91,34,125,,
3,225540,220.2539063,250,196,446,,
3,229422,224.0449219,267,216,483,,
3,233296,227.828125,93,39,132,,
3,237166,231.6074219,84,23,107,,
3,241034,235.3847656,82,25,107,,
3,244906,239.1660156,946,883,1829,,
3,248792,242.9609375,117,33,150,,
3,252670,246.7480469,111,17,128,,
3,256558,250.5449219,122,29,151,,
3,260450,254.3457031,123,34,157,,
3,264322,258.1269531,154,67,221,,
3,268204,261.9179688,120,34,154,,
3,272092,265.7148438,88,32,120,,
3,275956,269.4882813,496,436,932,,
3,279834,273.2753906,132,50,182,,
3,283704,277.0546875,1304,1217,2521,,
3,287590,280.8496094,110,39,149,,
3,291470,284.6386719,97,35,132,,
3,295346,288.4238281,88,33,121,BAn15m7 (iteration 3),
3,4664,4.5546875,45,19,64,,
3,8540,8.33984375,64,24,88,,
3,12416,12.125,47,19,66,,
3,16298,15.91601563,53,19,72,,
3,20192,19.71875,46,16,62,,
3,24064,23.5,49,19,68,,
3,27934,27.27929688,51,19,70,,
3,31808,31.0625,54,21,75,,
3,35692,34.85546875,59,28,87,,
3,39572,38.64453125,53,32,85,,
3,43444,42.42578125,54,31,85,,
3,47322,46.21289063,51,27,78,,
3,51196,49.99609375,66,27,93,,
3,55074,53.78320313,58,30,88,,
3,58940,57.55859375,54,18,72,,
3,62812,61.33984375,50,29,79,,
3,66692,65.12890625,51,29,80,,
3,70572,68.91796875,54,27,81,,
3,74456,72.7109375,57,21,78,,
3,78338,76.50195313,54,16,70,,
3,82210,80.28320313,63,18,81,,
3,86086,84.06835938,75,26,101,,
3,89964,87.85546875,83,47,130,,
3,93856,91.65625,57,31,88,,
3,97722,95.43164063,75,25,100,,
3,101596,99.21484375,840,803,1643,,
3,105452,102.9804688,53,18,71,,
3,109326,106.7636719,65,33,98,,
3,113198,110.5449219,70,27,97,,
3,117066,114.3222656,59,17,76,,
3,120950,118.1152344,61,16,77,,
3,124830,121.9042969,58,17,75,,
3,128718,125.7011719,284,255,539,,
3,132592,129.484375,58,17,75,,
3,136472,133.2734375,58,17,75,,
3,140358,137.0683594,67,22,89,,
3,144232,140.8515625,63,25,88,,
3,148112,144.640625,57,32,89,,
3,152000,148.4375,63,23,86,,
3,155866,152.2128906,57,18,75,,
3,159738,155.9941406,69,30,99,,
3,163620,159.7851563,82,16,98,,
3,167498,163.5722656,83,31,114,,
3,171380,167.3632813,499,441,940,,
3,175238,171.1308594,73,43,116,,
3,179122,174.9238281,72,25,97,,
3,183000,178.7109375,69,18,87,,
3,186882,182.5019531,80,15,95,,
3,190754,186.2832031,67,19,86,,
3,194624,190.0625,1169,1102,2271,,
3,198496,193.84375,83,18,101,,
3,202378,197.6347656,92,13,105,,
3,206256,201.421875,101,33,134,,
3,210126,205.2011719,87,16,103,,
3,214002,208.9863281,76,26,102,,
3,217888,212.78125,91,32,123,,
3,221756,216.5585938,278,226,504,,
3,225630,220.3417969,86,17,103,,
3,229494,224.1152344,95,41,136,,
3,233358,227.8886719,84,34,118,,
3,237240,231.6796875,85,30,115,,
3,241110,235.4589844,171,114,285,,
3,244974,239.2324219,84,30,114,,
3,248842,243.0097656,114,33,147,,
3,252722,246.7988281,126,33,159,,
3,256588,250.5742188,122,27,149,,
3,260462,254.3574219,127,34,161,,
3,264334,258.1386719,105,24,129,,
3,268208,261.921875,85,29,114,,
3,272090,265.7128906,94,31,125,,
3,275954,269.4863281,102,41,143,,
3,279838,273.2792969,2549,2499,5048,,
3,283708,277.0585938,98,32,130,,
3,287574,280.8339844,82,22,104,,
3,291438,284.6074219,94,31,125,,
3,295326,288.4042969,96,33,129,,
3,299188,292.1757813,101,35,136,BAn15m7 (iteration 4),
3,4680,4.5703125,57,25,82,,
3,8568,8.3671875,54,24,78,,
3,12434,12.14257813,49,19,68,,
3,16308,15.92578125,64,28,92,,
3,20188,19.71484375,52,19,71,,
3,24064,23.5,51,17,68,,
3,27948,27.29296875,51,18,69,,
3,31826,31.08007813,52,29,81,,
3,35692,34.85546875,55,35,90,,
3,39568,38.640625,45,25,70,,
3,43444,42.42578125,54,31,85,,
3,47322,46.21289063,54,34,88,,
3,51192,49.9921875,71,20,91,,
3,55074,53.78320313,55,26,81,,
3,58950,57.56835938,81,40,121,,
3,62830,61.35742188,79,31,110,,
3,66688,65.125,84,40,124,,
3,70564,68.91015625,82,36,118,,
3,74430,72.68554688,70,27,97,,
3,78312,76.4765625,78,32,110,,
3,82178,80.25195313,59,24,83,,
3,86064,84.046875,54,21,75,,
3,89934,87.82617188,55,17,72,,
3,93802,91.60351563,64,38,102,,
3,97698,95.40820313,80,37,117,,
3,101568,99.1875,1045,991,2036,,
3,105448,102.9765625,125,89,214,,
3,109328,106.765625,62,27,89,,
3,113208,110.5546875,56,17,73,,
3,117072,114.328125,60,18,78,,
3,120948,118.1132813,67,21,88,,
3,124816,121.890625,65,25,90,,
3,128692,125.6757813,72,28,100,,
3,132562,129.4550781,69,32,101,,
3,136446,133.2480469,65,9,74,,
3,140336,137.046875,56,31,87,,
3,144204,140.8242188,55,31,86,,
3,148082,144.6113281,81,33,114,,
3,151968,148.40625,65,39,104,,
3,155834,152.1816406,65,21,86,,
3,159710,155.9667969,75,16,91,,
3,163580,159.7460938,72,17,89,,
3,167472,163.546875,131,85,216,,
3,171350,167.3339844,87,35,122,,
3,175236,171.1289063,82,31,113,,
3,179112,174.9140625,76,27,103,,
3,183000,178.7109375,58,16,74,,
3,186874,182.4941406,351,307,658,,
3,190746,186.2753906,69,27,96,,
3,194630,190.0683594,62,17,79,,
3,198492,193.8398438,63,19,82,,
3,202378,197.6347656,66,17,83,,
3,206264,201.4296875,77,25,102,,
3,210144,205.21875,980,935,1915,,
3,214016,209,223,157,380,,
3,217892,212.7851563,89,37,126,,
3,221776,216.578125,69,17,86,,
3,225648,220.359375,947,908,1855,,
3,229534,224.1542969,85,32,117,,
3,233410,227.9394531,94,34,128,,
3,237272,231.7109375,108,16,124,,
3,241154,235.5019531,84,18,102,,
3,245036,239.2929688,78,29,107,,
3,248920,243.0859375,1133,1074,2207,,
3,252792,246.8671875,99,17,116,,
3,256666,250.6503906,100,29,129,,
3,260542,254.4355469,80,25,105,,
3,264428,258.2304688,84,27,111,,
3,268296,262.0078125,105,39,144,,
3,272176,265.796875,110,37,147,,
3,276056,269.5859375,82,21,103,,
3,279944,273.3828125,92,31,123,,
3,283814,277.1621094,113,47,160,,
3,287692,280.9492188,859,800,1659,,
3,291566,284.7324219,99,33,132,,
3,295454,288.5292969,85,21,106,,
3,299334,292.3183594,98,32,130,BAn15m7 (iteration 5),
3,4660,4.55078125,48,19,67,,
3,8542,8.341796875,44,11,55,,
3,12414,12.12304688,62,26,88,,
3,16294,15.91210938,67,27,94,,
3,20170,19.69726563,66,20,86,,
3,24032,23.46875,54,18,72,,
3,27918,27.26367188,49,16,65,,
3,31798,31.05273438,55,23,78,,
3,35670,34.83398438,49,18,67,,
3,39558,38.63085938,57,24,81,,
3,43450,42.43164063,53,29,82,,
3,47326,46.21679688,49,24,73,,
3,51200,50,65,31,96,,
3,55064,53.7734375,65,25,90,,
3,58954,57.57226563,64,24,88,,
3,62842,61.36914063,62,25,87,,
3,66716,65.15234375,55,33,88,,
3,70586,68.93164063,52,31,83,,
3,74466,72.72070313,60,34,94,,
3,78358,76.52148438,73,32,105,,
3,82242,80.31445313,62,19,81,,
3,86120,84.1015625,53,18,71,,
3,89982,87.87304688,61,25,86,,
3,93858,91.65820313,53,17,70,,
3,97724,95.43359375,56,16,72,,
3,101594,99.21289063,84,28,112,,
3,105434,102.9628906,97,29,126,,
3,109318,106.7558594,84,35,119,,
3,113180,110.5273438,81,36,117,,
3,117058,114.3144531,76,28,104,,
3,120950,118.1152344,63,37,100,,
3,124834,121.9082031,69,24,93,,
3,128720,125.703125,57,30,87,,
3,132608,129.5,65,40,105,,
3,136472,133.2734375,681,626,1307,,
3,140348,137.0585938,337,295,632,,
3,144218,140.8378906,99,51,150,,
3,148080,144.609375,85,28,113,,
3,151972,148.4101563,253,202,455,,
3,155844,152.1914063,144,100,244,,
3,159730,155.9863281,95,46,141,,
3,163606,159.7714844,81,28,109,,
3,167494,163.5683594,74,28,102,,
3,171378,167.3613281,80,34,114,,
3,175244,171.1367188,80,18,98,,
3,179114,174.9160156,660,601,1261,,
3,182984,178.6953125,63,26,89,,
3,186860,182.4804688,80,30,110,,
3,190732,186.2617188,63,17,80,,
3,194616,190.0546875,779,719,1498,,
3,198490,193.8378906,81,31,112,,
3,202354,197.6113281,78,27,105,,
3,206220,201.3867188,950,889,1839,,
3,210106,205.1816406,79,29,108,,
3,213972,208.9570313,711,661,1372,,
3,217850,212.7441406,89,35,124,,
3,221724,216.5273438,84,29,113,,
3,225598,220.3105469,413,362,775,,
3,229476,224.0976563,69,19,88,,
3,233350,227.8808594,86,18,104,,
3,237218,231.6582031,74,19,93,,
3,241098,235.4472656,80,22,102,,
3,244974,239.2324219,98,34,132,,
3,248858,243.0253906,89,26,115,,
3,252720,246.796875,84,19,103,,
3,256604,250.5898438,93,36,129,,
3,260484,254.3789063,94,46,140,,
3,264358,258.1621094,105,39,144,,
3,268234,261.9472656,90,32,122,,
3,272122,265.7441406,100,40,140,,
3,275990,269.5214844,98,33,131,,
3,279868,273.3085938,97,35,132,,
3,283740,277.0898438,123,17,140,,
3,287624,280.8828125,91,34,125,,
3,291496,284.6640625,72,19,91,,
3,295366,288.4433594,1301,1230,2531,,
3,299244,292.2304688,122,42,164,,
3,303124,296.0195313,114,33,147,,
3,306986,299.7910156,99,28,127,,
3,310864,303.578125,99,32,131,,
3,314740,307.3632813,104,34,138,,
3,318604,311.1367188,96,27,123,,
3,322486,314.9277344,112,25,137,,
3,326380,318.7304688,115,34,149,,
3,330262,322.5214844,112,40,152,,
3,334152,326.3203125,1783,1674,3457,,
3,338036,330.1132813,1242,1128,2370,,
3,341922,333.9082031,157,38,195,,
3,345808,337.703125,133,39,172,,
3,349700,341.5039063,108,36,144,,
3,353568,345.28125,112,38,150,,
3,357436,349.0585938,116,31,147,,
3,361312,352.84375,91,28,119,,
3,365182,356.6230469,1386,1318,2704,,
3,369050,360.4003906,1214,1148,2362,BAn15m10 (iteration 1),
3,4676,4.56640625,61,26,87,,
3,8562,8.361328125,64,19,83,,
3,12438,12.14648438,54,18,72,,
3,16314,15.93164063,58,19,77,,
3,20188,19.71484375,64,23,87,,
3,24070,23.50585938,55,19,74,,
3,27950,27.29492188,62,26,88,,
3,31844,31.09765625,56,23,79,,
3,35730,34.89257813,63,28,91,,
3,39612,38.68359375,58,23,81,,
3,43484,42.46484375,59,38,97,,
3,47362,46.25195313,47,18,65,,
3,51242,50.04101563,60,39,99,,
3,55112,53.8203125,59,35,94,,
3,58986,57.60351563,68,40,108,,
3,62862,61.38867188,58,36,94,,
3,66728,65.1640625,69,29,98,,
3,70604,68.94921875,50,30,80,,
3,74484,72.73828125,57,22,79,,
3,78370,76.53320313,74,18,92,,
3,82254,80.32617188,59,17,76,,
3,86132,84.11328125,52,13,65,,
3,90014,87.90429688,64,24,88,,
3,93888,91.6875,94,42,136,,
3,97760,95.46875,84,29,113,,
3,101622,99.24023438,82,17,99,,
3,105472,103,61,17,78,,
3,109352,106.7890625,54,24,78,,
3,113222,110.5683594,63,34,97,,
3,117092,114.3476563,57,20,77,,
3,120956,118.1210938,78,31,109,,
3,124822,121.8964844,89,34,123,,
3,128706,125.6894531,74,27,101,,
3,132578,129.4707031,72,44,116,,
3,136454,133.2558594,1439,1394,2833,,
3,140338,137.0488281,66,25,91,,
3,144228,140.8476563,554,514,1068,,
3,148100,144.6289063,154,111,265,,
3,151988,148.4257813,79,26,105,,
3,155880,152.2265625,277,226,503,,
3,159742,155.9980469,58,17,75,,
3,163620,159.7851563,58,17,75,,
3,167508,163.5820313,61,32,93,,
3,171398,167.3808594,854,799,1653,,
3,175278,171.1699219,78,18,96,,
3,179152,174.953125,78,29,107,,
3,183010,178.7207031,64,18,82,,
3,186888,182.5078125,64,31,95,,
3,190778,186.3066406,662,624,1286,,
3,194646,190.0839844,106,33,139,,
3,198528,193.875,69,17,86,,
3,202406,197.6621094,81,30,111,,
3,206288,201.453125,679,629,1308,,
3,210158,205.2324219,63,18,81,,
3,214038,209.0214844,792,741,1533,,
3,217916,212.8085938,84,31,115,,
3,221792,216.59375,101,35,136,,
3,225668,220.3789063,91,31,122,,
3,229546,224.1660156,263,210,473,,
3,233430,227.9589844,92,34,126,,
3,237312,231.75,104,36,140,,
3,241192,235.5390625,100,33,133,,
3,245068,239.3242188,98,37,135,,
3,248940,243.1054688,99,35,134,,
3,252806,246.8808594,86,22,108,,
3,256688,250.671875,585,520,1105,,
3,260564,254.4570313,103,24,127,,
3,264440,258.2421875,99,35,134,,
3,268320,262.03125,96,32,128,,
3,272194,265.8144531,79,18,97,,
3,276072,269.6015625,88,25,113,,
3,279950,273.3886719,84,28,112,,
3,283812,277.1601563,84,28,112,,
3,287684,280.9414063,98,35,133,,
3,291570,284.7363281,88,25,113,,
3,295440,288.515625,1190,1126,2316,,
3,299312,292.296875,94,26,120,,
3,303188,296.0820313,107,22,129,,
3,307076,299.8789063,220,151,371,,
3,310932,303.6445313,117,54,171,,
3,314828,307.4492188,98,32,130,,
3,318704,311.234375,103,34,137,,
3,322576,315.015625,108,42,150,,
3,326460,318.8085938,97,33,130,,
3,330338,322.5957031,97,17,114,,
3,334216,326.3828125,1865,1792,3657,,
3,338108,330.1835938,98,36,134,,
3,341988,333.9726563,96,32,128,,
3,345872,337.765625,98,32,130,,
3,349736,341.5390625,109,29,138,,
3,353616,345.328125,102,35,137,,
3,357492,349.1132813,97,33,130,,
3,361378,352.9082031,100,34,134,,
3,365248,356.6875,2634,2563,5197,,
3,369124,360.4726563,1164,1082,2246,BAn15m10 (iteration 2),
3,4670,4.560546875,53,20,73,,
3,8540,8.33984375,50,19,69,,
3,12422,12.13085938,47,20,67,,
3,16308,15.92578125,53,20,73,,
3,20176,19.703125,68,24,92,,
3,24062,23.49804688,61,23,84,,
3,27948,27.29296875,49,19,68,,
3,31836,31.08984375,51,18,69,,
3,35716,34.87890625,58,23,81,,
3,39592,38.6640625,54,21,75,,
3,43462,42.44335938,64,34,98,,
3,47344,46.234375,47,28,75,,
3,51218,50.01757813,59,19,78,,
3,55112,53.8203125,55,31,86,,
3,58988,57.60546875,83,41,124,,
3,62856,61.3828125,54,18,72,,
3,66728,65.1640625,50,31,81,,
3,70602,68.94726563,56,34,90,,
3,74478,72.73242188,54,34,88,,
3,78350,76.51367188,50,17,67,,
3,82210,80.28320313,65,21,86,,
3,86090,84.07226563,56,20,76,,
3,89962,87.85351563,53,15,68,,
3,93832,91.6328125,61,11,72,,
3,97722,95.43164063,61,21,82,,
3,101602,99.22070313,53,17,70,,
3,105474,103.0019531,61,21,82,,
3,109348,106.7851563,64,30,94,,
3,113226,110.5722656,48,25,73,,
3,117102,114.3574219,66,40,106,,
3,120962,118.1269531,72,41,113,,
3,124834,121.9082031,420,374,794,,
3,128718,125.7011719,324,263,587,,
3,132596,129.4882813,565,528,1093,,
3,136452,133.2539063,2050,2010,4060,,
3,140318,137.0292969,55,17,72,,
3,144190,140.8105469,811,766,1577,,
3,148070,144.5996094,84,29,113,,
3,151948,148.3867188,79,29,108,,
3,155824,152.171875,59,17,76,,
3,159716,155.9726563,72,29,101,,
3,163582,159.7480469,75,30,105,,
3,167460,163.5351563,76,32,108,,
3,171352,167.3359375,104,58,162,,
3,175230,171.1230469,188,155,343,,
3,179086,174.8886719,674,641,1315,,
3,182958,178.6699219,144,92,236,,
3,186824,182.4453125,81,34,115,,
3,190696,186.2265625,71,22,93,,
3,194564,190.0039063,91,26,117,,
3,198450,193.7988281,107,20,127,,
3,202332,197.5898438,140,30,170,,
3,206202,201.3691406,813,762,1575,,
3,210060,205.1367188,104,52,156,,
3,213930,208.9160156,911,860,1771,,
3,217812,212.7070313,85,36,121,,
3,221692,216.4960938,84,35,119,,
3,225560,220.2734375,85,37,122,,
3,229426,224.0488281,83,16,99,,
3,233296,227.828125,81,32,113,,
3,237176,231.6171875,97,38,135,,
3,241058,235.4082031,96,36,132,,
3,244932,239.1914063,82,29,111,,
3,248804,242.9726563,83,31,114,,
3,252690,246.7675781,93,36,129,,
3,256576,250.5625,885,809,1694,,
3,260454,254.3496094,92,30,122,,
3,264332,258.1367188,76,22,98,,
3,268212,261.9257813,85,15,100,,
3,272082,265.7050781,101,36,137,,
3,275956,269.4882813,103,48,151,,
3,279848,273.2890625,116,48,164,,
3,283728,277.078125,75,21,96,,
3,287600,280.859375,90,34,124,,
3,291480,284.6484375,92,31,123,,
3,295364,288.4414063,106,38,144,,
3,299238,292.2246094,239,164,403,,
3,303096,295.9921875,879,812,1691,,
3,306992,299.796875,98,36,134,,
3,310868,303.5820313,83,25,108,,
3,314750,307.3730469,81,25,106,,
3,318628,311.1601563,88,17,105,,
3,322506,314.9472656,91,35,126,,
3,326392,318.7421875,90,33,123,,
3,330262,322.5214844,96,33,129,,
3,334134,326.3027344,2888,2830,5718,,
3,338004,330.0820313,93,33,126,,
3,341876,333.8632813,106,51,157,,
3,345748,337.6445313,91,33,124,,
3,349628,341.4335938,97,35,132,,
3,353498,345.2128906,100,39,139,,
3,357378,349.0019531,104,32,136,,
3,361258,352.7910156,97,34,131,,
3,365134,356.5761719,1376,1308,2684,,
3,369012,360.3632813,1834,1756,3590,BAn15m10 (iteration 3),
6,10258,10.01757813,780,551,1331,,
6,19732,19.26953125,787,520,1307,,
6,29210,28.52539063,794,532,1326,,
6,38692,37.78515625,761,564,1325,,
6,48166,47.03710938,785,559,1344,,
6,57658,56.30664063,883,644,1527,,
6,67130,65.55664063,809,548,1357,,
6,76604,74.80859375,775,541,1316,,
6,86084,84.06640625,813,595,1408,,
6,95560,93.3203125,814,585,1399,,
6,105032,102.5703125,333,67,400,,
6,114516,111.8320313,160,89,249,,
6,123990,121.0839844,159,103,262,,
6,133478,130.3496094,176,98,274,,
6,142954,139.6035156,164,84,248,,
6,152420,148.8476563,182,116,298,,
6,161886,158.0917969,257,164,421,,
6,171354,167.3378906,311,182,493,,
6,180818,176.5800781,350,220,570,,
6,190304,185.84375,499,100,599,,
6,199780,195.0976563,197,101,298,,
6,209240,204.3359375,195,113,308,,
6,218710,213.5839844,163,79,242,,
6,228180,222.8320313,200,85,285,,
6,237656,232.0859375,185,99,284,,
6,247118,241.3261719,174,104,278,,
6,256608,250.59375,193,107,300,,
6,266082,259.8457031,327,59,386,,
6,275554,269.0957031,200,110,310,,
6,285036,278.3554688,221,82,303,,
6,294512,287.609375,165,64,229,,
6,303974,296.8496094,780,692,1472,,
6,313448,306.1015625,771,691,1462,,
6,322924,315.3554688,726,644,1370,,
6,332402,324.6113281,675,373,1048,,
6,341886,333.8730469,643,476,1119,,
6,351370,343.1347656,499,423,922,,
6,360832,352.375,520,416,936,,
6,370310,361.6308594,483,392,875,,
6,379778,370.8769531,508,418,926,,
6,389248,380.125,554,294,848,,
6,398728,389.3828125,555,412,967,,
6,408196,398.6289063,603,508,1111,,
6,417664,407.875,768,653,1421,,
6,427132,417.1210938,546,455,1001,,
6,436618,426.3847656,615,423,1038,,
6,446086,435.6308594,617,506,1123,,
6,455564,444.8867188,610,526,1136,,
6,465038,454.1386719,636,508,1144,,
6,474512,463.390625,648,457,1105,,
6,483994,472.6503906,674,517,1191,,
6,493458,481.8925781,760,647,1407,,
6,502930,491.1425781,1275,1039,2314,,
6,512402,500.3925781,462,367,829,,
6,521868,509.6367188,1302,1093,2395,,
6,531334,518.8808594,819,134,953,,
6,540812,528.1367188,561,385,946,,
6,550296,537.3984375,437,297,734,,
6,559768,546.6484375,434,336,770,,
6,569252,555.9101563,577,471,1048,,
6,578730,565.1660156,577,476,1053,,
6,588216,574.4296875,571,463,1034,,
6,597686,583.6777344,587,442,1029,,
6,607164,592.9335938,599,413,1012,,
6,616654,602.2011719,610,493,1103,,
6,626132,611.4570313,935,209,1144,,
6,635612,620.7148438,582,348,930,,
6,645072,629.953125,525,399,924,,
6,654548,639.2070313,693,573,1266,,
6,664018,648.4550781,1795,1624,3419,,
6,673488,657.703125,1729,1594,3323,,
6,682962,666.9550781,1434,1275,2709,,
6,692436,676.2070313,2063,1878,3941,,
6,701918,685.4667969,1324,1212,2536,,
6,711388,694.7148438,1274,1133,2407,,
6,720872,703.9765625,1387,673,2060,,
6,730328,713.2109375,1212,1055,2267,,
6,739804,722.4648438,1024,891,1915,,
6,749286,731.7246094,1238,1085,2323,,
6,758756,740.9726563,1296,1132,2428,,
6,768230,750.2246094,1501,1285,2786,,
6,777710,759.4824219,1005,881,1886,,
6,787198,768.7480469,1475,1311,2786,,
6,796668,777.9960938,1203,1069,2272,,
6,806146,787.2519531,1279,1144,2423,,
6,815624,796.5078125,1354,624,1978,,
6,825094,805.7558594,974,806,1780,,
6,834578,815.0175781,1250,1089,2339,,
6,844054,824.2714844,1346,1189,2535,,
6,853552,833.546875,1507,1217,2724,,
6,863030,842.8027344,949,798,1747,,
6,872506,852.0566406,1239,1086,2325,,
6,881996,861.3242188,1231,1086,2317,,
6,891464,870.5703125,1243,1107,2350,,
6,900942,879.8261719,1329,1169,2498,BAn15m10 (iteration 1),
6,10270,10.02929688,97,55,152,,
6,19740,19.27734375,125,75,200,,
6,29236,28.55078125,132,71,203,,
6,38720,37.8125,89,45,134,,
6,48192,47.0625,97,57,154,,
6,57670,56.31835938,103,73,176,,
6,67152,65.578125,100,65,165,,
6,76628,74.83203125,110,62,172,,
6,86092,84.07421875,105,71,176,,
6,95562,93.32226563,110,60,170,,
6,105054,102.5917969,201,144,345,,
6,114536,111.8515625,130,68,198,,
6,124002,121.0957031,126,71,197,,
6,133468,130.3398438,1025,964,1989,,
6,142932,139.5820313,110,57,167,,
6,152396,148.8242188,114,56,170,,
6,161876,158.0820313,123,60,183,,
6,171358,167.3417969,2197,2043,4240,,
6,180844,176.6054688,129,69,198,,
6,190326,185.8652344,133,66,199,,
6,199802,195.1191406,137,66,203,,
6,209284,204.3789063,1031,967,1998,,
6,218740,213.6132813,140,71,211,,
6,228218,222.8691406,149,81,230,,
6,237676,232.1054688,951,892,1843,,
6,247154,241.3613281,129,58,187,,
6,256640,250.625,445,377,822,BAn15m2 (iteration 1),
6,10272,10.03125,100,56,156,,
6,19744,19.28125,109,63,172,,
6,29228,28.54296875,101,56,157,,
6,38710,37.80273438,93,64,157,,
6,48186,47.05664063,88,61,149,,
6,57664,56.3125,146,78,224,,
6,67164,65.58984375,99,58,157,,
6,76642,74.84570313,146,82,228,,
6,86116,84.09765625,143,86,229,,
6,95596,93.35546875,130,70,200,,
6,105078,102.6152344,126,65,191,,
6,114548,111.8632813,120,61,181,,
6,124030,121.1230469,110,58,168,,
6,133524,130.3945313,99,49,148,,
6,143002,139.6503906,103,54,157,,
6,152480,148.90625,134,71,205,,
6,161960,158.1640625,112,60,172,,
6,171440,167.421875,108,59,167,,
6,180916,176.6757813,165,96,261,,
6,190396,185.9335938,153,97,250,,
6,199874,195.1894531,106,53,159,,
6,209352,204.4453125,123,61,184,,
6,218844,213.7148438,609,540,1149,,
6,228324,222.9726563,122,61,183,,
6,237808,232.234375,128,68,196,,
6,247276,241.4804688,1036,955,1991,,
6,256764,250.7460938,135,62,197,BAn15m2 (iteration 2),
6,10274,10.03320313,95,53,148,,
6,19756,19.29296875,110,47,157,,
6,29222,28.53710938,91,64,155,,
6,38698,37.79101563,98,37,135,,
6,48180,47.05078125,96,69,165,,
6,57666,56.31445313,91,58,149,,
6,67134,65.56054688,93,66,159,,
6,76628,74.83203125,99,70,169,,
6,86110,84.09179688,109,76,185,,
6,95574,93.33398438,125,56,181,,
6,105048,102.5859375,116,50,166,,
6,114518,111.8339844,98,49,147,,
6,123994,121.0878906,114,49,163,,
6,133462,130.3339844,133,57,190,,
6,142932,139.5820313,108,59,167,,
6,152418,148.8457031,121,64,185,,
6,161894,158.0996094,143,73,216,,
6,171374,167.3574219,119,60,179,,
6,180854,176.6152344,150,94,244,,
6,190332,185.8710938,887,823,1710,,
6,199812,195.1289063,196,51,247,,
6,209282,204.3769531,126,78,204,,
6,218744,213.6171875,258,50,308,,
6,228224,222.875,1144,1078,2222,,
6,237718,232.1464844,190,58,248,,
6,247198,241.4042969,146,65,211,,
6,256662,250.6464844,273,63,336,BAn15m2 (iteration 3),
6,10272,10.03125,183,47,230,,
6,19752,19.2890625,220,170,390,,
6,29236,28.55078125,108,60,168,,
6,38710,37.80273438,93,51,144,,
6,48178,47.04882813,84,56,140,,
6,57648,56.296875,102,72,174,,
6,67122,65.54882813,102,56,158,,
6,76600,74.8046875,128,71,199,,
6,86086,84.06835938,118,72,190,,
6,95570,93.33007813,111,63,174,,
6,105038,102.5761719,108,61,169,,
6,114498,111.8144531,123,62,185,,
6,123970,121.0644531,123,55,178,,
6,133458,130.3300781,118,60,178,,
6,142934,139.5839844,136,77,213,,
6,152412,148.8398438,124,70,194,,
6,161886,158.0917969,115,54,169,,
6,171366,167.3496094,127,72,199,,
6,180840,176.6015625,216,57,273,,
6,190308,185.8476563,143,71,214,,
6,199790,195.1074219,152,88,240,,
6,209262,204.3574219,587,535,1122,,
6,218736,213.609375,101,48,149,,
6,228206,222.8574219,109,55,164,,
6,237676,232.1054688,124,59,183,,
6,247164,241.3710938,127,66,193,,
6,256644,250.6289063,129,62,191,BAn15m2 (iteration 4),
6,10270,10.02929688,87,50,137,,
6,19746,19.28320313,100,49,149,,
6,29218,28.53320313,100,46,146,,
6,38704,37.796875,88,53,141,,
6,48174,47.04492188,104,56,160,,
6,57648,56.296875,106,59,165,,
6,67114,65.54101563,103,59,162,,
6,76604,74.80859375,110,54,164,,
6,86072,84.0546875,105,60,165,,
6,95552,93.3125,223,51,274,,
6,105034,102.5722656,90,50,140,,
6,114518,111.8339844,194,67,261,,
6,123992,121.0859375,115,63,178,,
6,133480,130.3515625,302,154,456,,
6,142944,139.59375,158,97,255,,
6,152416,148.84375,144,62,206,,
6,161894,158.0996094,270,80,350,,
6,171368,167.3515625,130,57,187,,
6,180836,176.5976563,116,67,183,,
6,190314,185.8535156,115,59,174,,
6,199790,195.1074219,120,58,178,,
6,209278,204.3730469,508,453,961,,
6,218758,213.6308594,134,77,211,,
6,228254,222.9042969,102,51,153,,
6,237730,232.1582031,128,52,180,,
6,247206,241.4121094,115,57,172,,
6,256680,250.6640625,116,53,169,BAn15m2 (iteration 5),
6,10270,10.02929688,92,54,146,,
6,19746,19.28320313,97,52,149,,
6,29214,28.52929688,100,49,149,,
6,38674,37.76757813,99,51,150,,
6,48154,47.02539063,119,83,202,,
6,57634,56.28320313,104,70,174,,
6,67122,65.54882813,104,62,166,,
6,76600,74.8046875,98,60,158,,
6,86080,84.0625,106,63,169,,
6,95556,93.31640625,126,58,184,,
6,105026,102.5644531,129,84,213,,
6,114510,111.8261719,97,62,159,,
6,123980,121.0742188,115,66,181,,
6,133448,130.3203125,131,75,206,,
6,142924,139.5742188,128,71,199,,
6,152400,148.828125,153,81,234,,
6,161888,158.09375,135,74,209,,
6,171360,167.34375,131,73,204,,
6,180846,176.6074219,154,87,241,,
6,190330,185.8691406,124,62,186,,
6,199808,195.125,115,60,175,,
6,209290,204.3847656,127,71,198,,
6,218770,213.6425781,161,94,255,,
6,228242,222.8925781,994,929,1923,,
6,237728,232.15625,130,67,197,,
6,247204,241.4101563,116,57,173,,
6,256678,250.6621094,153,72,225,,
6,266146,259.9082031,182,120,302,,
6,275616,269.15625,107,48,155,,
6,285096,278.4140625,119,58,177,,
6,294584,287.6796875,125,59,184,,
6,304062,296.9355469,138,66,204,,
6,313552,306.203125,184,122,306,,
6,323042,315.4707031,529,459,988,,
6,332518,324.7246094,1345,1280,2625,,
6,342002,333.9863281,1041,975,2016,,
6,351462,343.2246094,663,586,1249,,
6,360936,352.4765625,443,367,810,,
6,370400,361.71875,457,388,845,BAn15m3 (iteration 1),
6,10270,10.02929688,98,55,153,,
6,19742,19.27929688,108,60,168,,
6,29222,28.53710938,104,66,170,,
6,38700,37.79296875,97,66,163,,
6,48190,47.06054688,91,52,143,,
6,57672,56.3203125,90,52,142,,
6,67142,65.56835938,94,54,148,,
6,76614,74.81835938,101,59,160,,
6,86094,84.07617188,101,73,174,,
6,95564,93.32421875,99,55,154,,
6,105050,102.5878906,111,66,177,,
6,114514,111.8300781,149,90,239,,
6,123990,121.0839844,132,67,199,,
6,133460,130.3320313,96,48,144,,
6,142942,139.5917969,101,72,173,,
6,152418,148.8457031,110,74,184,,
6,161882,158.0878906,141,77,218,,
6,171362,167.3457031,121,70,191,,
6,180844,176.6054688,104,50,154,,
6,190320,185.859375,448,398,846,,
6,199808,195.125,115,62,177,,
6,209292,204.3867188,720,661,1381,,
6,218760,213.6328125,135,62,197,,
6,228238,222.8886719,141,77,218,,
6,237696,232.125,122,61,183,,
6,247182,241.3886719,123,62,185,,
6,256662,250.6464844,124,57,181,,
6,266142,259.9042969,447,391,838,,
6,275628,269.1679688,124,60,184,,
6,285120,278.4375,125,61,186,,
6,294584,287.6796875,158,79,237,,
6,304066,296.9394531,132,64,196,,
6,313536,306.1875,132,64,196,,
6,323012,315.4414063,145,64,209,,
6,332490,324.6972656,572,512,1084,,
6,341986,333.9707031,1782,1726,3508,,
6,351470,343.2324219,602,533,1135,,
6,360958,352.4980469,717,630,1347,,
6,370444,361.7617188,457,387,844,BAn15m3 (iteration 2),
6,10282,10.04101563,91,56,147,,
6,19750,19.28710938,91,50,141,,
6,29228,28.54296875,90,52,142,,
6,38694,37.78710938,91,60,151,,
6,48164,47.03515625,92,67,159,,
6,57634,56.28320313,88,50,138,,
6,67114,65.54101563,87,49,136,,
6,76602,74.80664063,100,58,158,,
6,86068,84.05078125,95,52,147,,
6,95546,93.30664063,88,50,138,,
6,105020,102.5585938,103,61,164,,
6,114500,111.8164063,117,71,188,,
6,123962,121.0566406,108,74,182,,
6,133442,130.3144531,134,75,209,,
6,142916,139.5664063,125,69,194,,
6,152376,148.8046875,111,61,172,,
6,161842,158.0488281,107,57,164,,
6,171310,167.2949219,266,214,480,,
6,180792,176.5546875,889,841,1730,,
6,190266,185.8066406,102,49,151,,
6,199754,195.0722656,104,54,158,,
6,209234,204.3300781,525,474,999,,
6,218710,213.5839844,129,68,197,,
6,228182,222.8339844,115,59,174,,
6,237662,232.0917969,130,55,185,,
6,247136,241.34375,108,53,161,,
6,256610,250.5957031,125,62,187,,
6,266094,259.8574219,258,196,454,,
6,275572,269.1132813,133,63,196,,
6,285046,278.3652344,133,64,197,,
6,294514,287.6113281,126,63,189,,
6,303998,296.8730469,150,53,203,,
6,313472,306.125,153,65,218,,
6,322950,315.3808594,1697,1630,3327,,
6,332428,324.6367188,953,891,1844,,
6,341902,333.8886719,516,440,956,,
6,351382,343.1464844,553,482,1035,,
6,360864,352.40625,570,484,1054,,
6,370354,361.6738281,470,389,859,BAn15m3 (iteration 3),
6,10276,10.03515625,78,46,124,,
6,19740,19.27734375,92,51,143,,
6,29214,28.52929688,91,57,148,,
6,38702,37.79492188,96,64,160,,
6,48180,47.05078125,81,43,124,,
6,57650,56.29882813,100,63,163,,
6,67112,65.5390625,87,60,147,,
6,76576,74.78125,96,53,149,,
6,86046,84.02929688,118,64,182,,
6,95536,93.296875,109,80,189,,
6,105014,102.5527344,101,59,160,,
6,114494,111.8105469,94,49,143,,
6,123978,121.0722656,307,245,552,,
6,133448,130.3203125,96,51,147,,
6,142912,139.5625,100,54,154,,
6,152406,148.8339844,101,71,172,,
6,161900,158.1054688,106,61,167,,
6,171366,167.3496094,107,46,153,,
6,180838,176.5996094,166,100,266,,
6,190320,185.859375,273,208,481,,
6,199790,195.1074219,117,63,180,,
6,209280,204.375,107,56,163,,
6,218758,213.6308594,124,67,191,,
6,228238,222.8886719,139,74,213,,
6,237726,232.1542969,722,634,1356,,
6,247208,241.4140625,139,61,200,,
6,256688,250.671875,132,56,188,,
6,266184,259.9453125,950,892,1842,,
6,275668,269.2070313,122,62,184,,
6,285140,278.4570313,120,51,171,,
6,294612,287.7070313,154,46,200,,
6,304080,296.953125,157,67,224,,
6,313558,306.2089844,204,97,301,,
6,323036,315.4648438,500,418,918,,
6,332520,324.7265625,1263,1177,2440,,
6,341994,333.9785156,680,592,1272,,
6,351482,343.2441406,678,610,1288,,
6,360948,352.4882813,289,197,486,,
6,370426,361.7441406,401,322,723,BAn15m3 (iteration 4),
6,10274,10.03320313,90,57,147,,
6,19744,19.28125,92,50,142,,
6,29224,28.5390625,97,43,140,,
6,38702,37.79492188,96,54,150,,
6,48198,47.06835938,84,55,139,,
6,57668,56.31640625,100,39,139,,
6,67148,65.57421875,113,88,201,,
6,76628,74.83203125,95,55,150,,
6,86106,84.08789063,109,59,168,,
6,95574,93.33398438,85,42,127,,
6,105038,102.5761719,100,68,168,,
6,114494,111.8105469,102,57,159,,
6,123966,121.0605469,96,63,159,,
6,133456,130.328125,106,59,165,,
6,142920,139.5703125,112,59,171,,
6,152388,148.8164063,106,53,159,,
6,161862,158.0683594,131,77,208,,
6,171346,167.3300781,102,49,151,,
6,180834,176.5957031,109,58,167,,
6,190304,185.84375,107,40,147,,
6,199786,195.1035156,126,73,199,,
6,209278,204.3730469,122,61,183,,
6,218760,213.6328125,516,463,979,,
6,228238,222.8886719,119,55,174,,
6,237714,232.1425781,139,52,191,,
6,247198,241.4042969,1291,1207,2498,,
6,256666,250.6503906,127,57,184,,
6,266146,259.9082031,126,51,177,,
6,275614,269.1542969,130,60,190,,
6,285092,278.4101563,712,636,1348,,
6,294554,287.6503906,134,64,198,,
6,304038,296.9121094,116,59,175,,
6,313540,306.1914063,141,73,214,,
6,323016,315.4453125,785,693,1478,,
6,332488,324.6953125,784,690,1474,,
6,341966,333.9511719,515,443,958,,
6,351454,343.2167969,428,351,779,,
6,360940,352.4804688,487,391,878,,
6,370420,361.7382813,443,345,788,BAn15m3 (iteration 5),
6,10274,10.03320313,80,46,126,,
6,19754,19.29101563,95,53,148,,
6,29234,28.54882813,84,47,131,,
6,38710,37.80273438,95,53,148,,
6,48184,47.0546875,92,55,147,,
6,57648,56.296875,104,64,168,,
6,67134,65.56054688,93,66,159,,
6,76606,74.81054688,104,69,173,,
6,86082,84.06445313,96,66,162,,
6,95574,93.33398438,112,81,193,,
6,105046,102.5839844,113,74,187,,
6,114526,111.8417969,89,60,149,,
6,124008,121.1015625,95,52,147,,
6,133492,130.3632813,107,65,172,,
6,142956,139.6054688,861,805,1666,,
6,152430,148.8574219,108,45,153,,
6,161912,158.1171875,100,45,145,,
6,171384,167.3671875,115,54,169,,
6,180870,176.6308594,100,46,146,,
6,190362,185.9003906,131,65,196,,
6,199838,195.1542969,112,56,168,,
6,209316,204.4101563,188,118,306,,
6,218790,213.6621094,141,68,209,,
6,228252,222.9023438,111,59,170,,
6,237742,232.1699219,112,46,158,,
6,247224,241.4296875,652,589,1241,,
6,256716,250.6992188,144,64,208,,
6,266196,259.9570313,132,52,184,,
6,275668,269.2070313,119,49,168,,
6,285156,278.4726563,152,71,223,,
6,294632,287.7265625,146,62,208,,
6,304102,296.9746094,937,874,1811,,
6,313590,306.2402344,129,63,192,,
6,323070,315.4980469,125,61,186,,
6,332532,324.7382813,904,841,1745,,
6,342012,333.9960938,194,92,286,,
6,351482,343.2441406,1082,1006,2088,,
6,360966,352.5058594,933,859,1792,,
6,370434,361.7519531,825,751,1576,,
6,379916,371.0117188,503,436,939,,
6,389398,380.2714844,669,571,1240,,
6,398890,389.5410156,639,530,1169,,
6,408372,398.8007813,595,499,1094,,
6,417840,408.046875,521,432,953,,
6,427308,417.2929688,669,595,1264,,
6,436782,426.5449219,537,459,996,,
6,446256,435.796875,782,707,1489,,
6,455714,445.0332031,617,537,1154,,
6,465200,454.296875,585,500,1085,,
6,474678,463.5527344,635,556,1191,,
6,484160,472.8125,588,510,1098,,
6,493632,482.0625,627,543,1170,,
6,503114,491.3222656,686,606,1292,,
6,512588,500.5742188,589,496,1085,,
6,522070,509.8339844,705,617,1322,,
6,531552,519.09375,705,557,1262,,
6,541018,528.3378906,564,470,1034,,
6,550502,537.5996094,659,573,1232,,
6,559980,546.8554688,597,493,1090,,
6,569452,556.1054688,625,516,1141,BAn15m5 (iteration 1),
6,10272,10.03125,92,57,149,,
6,19740,19.27734375,92,50,142,,
6,29226,28.54101563,80,46,126,,
6,38704,37.796875,117,70,187,,
6,48164,47.03515625,101,62,163,,
6,57638,56.28710938,100,47,147,,
6,67130,65.55664063,96,58,154,,
6,76602,74.80664063,96,54,150,,
6,86078,84.06054688,120,79,199,,
6,95552,93.3125,101,58,159,,
6,105024,102.5625,100,67,167,,
6,114510,111.8261719,104,56,160,,
6,123976,121.0703125,103,50,153,,
6,133452,130.3242188,140,79,219,,
6,142930,139.5800781,1330,1290,2620,,
6,152396,148.8242188,304,250,554,,
6,161880,158.0859375,102,46,148,,
6,171354,167.3378906,101,48,149,,
6,180838,176.5996094,109,48,157,,
6,190306,185.8457031,110,52,162,,
6,199786,195.1035156,110,59,169,,
6,209250,204.3457031,119,62,181,,
6,218736,213.609375,113,59,172,,
6,228210,222.8613281,141,78,219,,
6,237682,232.1113281,132,65,197,,
6,247152,241.359375,135,68,203,,
6,256630,250.6152344,964,909,1873,,
6,266090,259.8535156,135,63,198,,
6,275570,269.1113281,115,49,164,,
6,285068,278.3867188,174,116,290,,
6,294532,287.6289063,1121,1065,2186,,
6,304008,296.8828125,117,56,173,,
6,313496,306.1484375,116,51,167,,
6,322986,315.4160156,113,52,165,,
6,332468,324.6757813,940,876,1816,,
6,341946,333.9316406,1019,952,1971,,
6,351416,343.1796875,799,721,1520,,
6,360888,352.4296875,723,658,1381,,
6,370350,361.6699219,455,391,846,,
6,379826,370.9238281,731,661,1392,,
6,389308,380.1835938,587,504,1091,,
6,398774,389.4277344,695,626,1321,,
6,408244,398.6757813,678,603,1281,,
6,417728,407.9375,516,440,956,,
6,427198,417.1855469,713,640,1353,,
6,436674,426.4394531,550,470,1020,,
6,446150,435.6933594,794,683,1477,,
6,455642,444.9628906,691,567,1258,,
6,465122,454.2207031,553,470,1023,,
6,474598,463.4746094,612,529,1141,,
6,484092,472.7460938,623,528,1151,,
6,493572,482.0039063,411,319,730,,
6,503060,491.2695313,498,414,912,,
6,512540,500.5273438,585,459,1044,,
6,522018,509.7832031,901,759,1660,,
6,531496,519.0390625,582,489,1071,,
6,540962,528.2832031,589,496,1085,,
6,550434,537.5332031,642,542,1184,,
6,559914,546.7910156,595,484,1079,,
6,569392,556.046875,604,510,1114,,
6,10276,10.03515625,97,62,159,BAn15m5 (iteration 2),
6,19756,19.29296875,91,50,141,,
6,29222,28.53710938,96,58,154,,
6,38700,37.79296875,98,59,157,,
6,48176,47.046875,113,68,181,,
6,57642,56.29101563,100,70,170,,
6,67126,65.55273438,123,71,194,,
6,76604,74.80859375,98,72,170,,
6,86076,84.05859375,109,81,190,,
6,95546,93.30664063,106,59,165,,
6,105024,102.5625,99,71,170,,
6,114498,111.8144531,123,80,203,,
6,123974,121.0683594,1544,1486,3030,,
6,133458,130.3300781,117,62,179,,
6,142936,139.5859375,228,178,406,,
6,152412,148.8398438,106,64,170,,
6,161882,158.0878906,109,46,155,,
6,171362,167.3457031,100,51,151,,
6,180832,176.59375,112,47,159,,
6,190314,185.8535156,107,60,167,,
6,199794,195.1113281,113,56,169,,
6,209270,204.3652344,697,627,1324,,
6,218746,213.6191406,111,45,156,,
6,228226,222.8769531,116,50,166,,
6,237704,232.1328125,110,57,167,,
6,247164,241.3710938,211,154,365,,
6,256658,250.6425781,142,65,207,,
6,266138,259.9003906,128,74,202,,
6,275608,269.1484375,143,73,216,,
6,285084,278.4023438,160,87,247,,
6,294552,287.6484375,138,68,206,,
6,304022,296.8964844,978,904,1882,,
6,313486,306.1386719,123,61,184,,
6,322962,315.3925781,116,56,172,,
6,332452,324.6601563,275,213,488,,
6,341920,333.90625,2496,2430,4926,,
6,351412,343.1757813,484,405,889,,
6,360890,352.4316406,762,696,1458,,
6,370374,361.6933594,602,535,1137,,
6,379854,370.9511719,521,454,975,,
6,389340,380.2148438,881,809,1690,,
6,398822,389.4746094,245,155,400,,
6,408306,398.7363281,478,401,879,,
6,417778,407.9863281,763,670,1433,,
6,427254,417.2402344,600,524,1124,,
6,436740,426.5039063,688,601,1289,,
6,446216,435.7578125,610,532,1142,,
6,455686,445.0058594,659,563,1222,,
6,465168,454.265625,501,425,926,,
6,474650,463.5253906,615,513,1128,,
6,484132,472.7851563,996,925,1921,,
6,493618,482.0488281,371,269,640,,
6,503112,491.3203125,441,343,784,,
6,512586,500.5722656,717,619,1336,,
6,522064,509.828125,697,606,1303,,
6,531540,519.0820313,1058,951,2009,,
6,541022,528.3417969,419,327,746,,
6,550502,537.5996094,382,291,673,,
6,559984,546.859375,571,485,1056,,
6,569456,556.109375,769,680,1449,BAn15m5 (iteration 3),
6,10278,10.03710938,108,59,167,,
6,19764,19.30078125,139,90,229,,
6,29232,28.546875,139,90,229,,
6,38718,37.81054688,109,53,162,,
6,48212,47.08203125,83,47,130,,
6,57670,56.31835938,86,60,146,,
6,67148,65.57421875,100,70,170,,
6,76622,74.82617188,104,77,181,,
6,86092,84.07421875,95,72,167,,
6,95570,93.33007813,100,51,151,,
6,105044,102.5820313,96,64,160,,
6,114520,111.8359375,108,55,163,,
6,123990,121.0839844,1455,1399,2854,,
6,133468,130.3398438,98,55,153,,
6,142944,139.59375,347,310,657,,
6,152440,148.8671875,108,58,166,,
6,161910,158.1152344,121,70,191,,
6,171380,167.3632813,108,62,170,,
6,180854,176.6152344,95,48,143,,
6,190312,185.8515625,115,65,180,,
6,199798,195.1152344,112,56,168,,
6,209294,204.3886719,169,119,288,,
6,218770,213.6425781,121,67,188,,
6,228254,222.9042969,100,47,147,,
6,237722,232.1503906,110,54,164,,
6,247192,241.3984375,511,455,966,,
6,256672,250.65625,130,56,186,,
6,266152,259.9140625,132,63,195,,
6,275628,269.1679688,129,60,189,,
6,285122,278.4394531,123,54,177,,
6,294598,287.6933594,128,65,193,,
6,304060,296.9335938,965,902,1867,,
6,313548,306.1992188,110,50,160,,
6,323016,315.4453125,147,83,230,,
6,332490,324.6972656,1196,1139,2335,,
6,341956,333.9414063,1142,1077,2219,,
6,351420,343.1835938,668,602,1270,,
6,360906,352.4472656,845,775,1620,,
6,370380,361.6992188,445,371,816,,
6,379862,370.9589844,656,591,1247,,
6,389342,380.2167969,436,351,787,,
6,398814,389.4667969,185,115,300,,
6,408292,398.7226563,607,537,1144,,
6,417766,407.9746094,649,569,1218,,
6,427232,417.21875,605,538,1143,,
6,436696,426.4609375,778,698,1476,,
6,446170,435.7128906,659,547,1206,,
6,455648,444.96875,596,510,1106,,
6,465124,454.2226563,536,443,979,,
6,474596,463.4726563,591,503,1094,,
6,484074,472.7285156,650,559,1209,,
6,493552,481.984375,705,620,1325,,
6,503042,491.2519531,728,636,1364,,
6,512528,500.515625,523,442,965,,
6,521996,509.7617188,831,741,1572,,
6,531478,519.0214844,551,447,998,,
6,540966,528.2871094,599,499,1098,,
6,550460,537.5585938,555,472,1027,,
6,559932,546.8085938,586,503,1089,,
6,569410,556.0644531,657,565,1222,BAn15m5 (iteration 4),
6,10270,10.02929688,80,50,130,,
6,19746,19.28320313,87,50,137,,
6,29224,28.5390625,110,68,178,,
6,38714,37.80664063,116,70,186,,
6,48192,47.0625,89,48,137,,
6,57660,56.30859375,108,51,159,,
6,67148,65.57421875,98,59,157,,
6,76624,74.828125,95,57,152,,
6,86104,84.0859375,97,57,154,,
6,95584,93.34375,97,52,149,,
6,105052,102.5898438,88,52,140,,
6,114534,111.8496094,96,55,151,,
6,123976,121.0703125,102,53,155,,
6,133462,130.3339844,99,52,151,,
6,142944,139.59375,1614,1564,3178,,
6,152418,148.8457031,102,59,161,,
6,161888,158.09375,100,50,150,,
6,171362,167.3457031,114,63,177,,
6,180840,176.6015625,117,67,184,,
6,190314,185.8535156,104,56,160,,
6,199800,195.1171875,258,206,464,,
6,209286,204.3808594,110,58,168,,
6,218762,213.6347656,113,62,175,,
6,228244,222.8945313,104,50,154,,
6,237752,232.1796875,110,61,171,,
6,247240,241.4453125,119,45,164,,
6,256714,250.6972656,551,485,1036,,
6,266194,259.9550781,122,54,176,,
6,275656,269.1953125,122,73,195,,
6,285130,278.4472656,125,48,173,,
6,294608,287.703125,122,55,177,,
6,304096,296.96875,141,72,213,,
6,313574,306.2246094,952,875,1827,,
6,323056,315.484375,428,343,771,,
6,332520,324.7265625,2129,2038,4167,,
6,342014,333.9980469,519,445,964,,
6,351494,343.2558594,637,563,1200,,
6,360966,352.5058594,612,538,1150,,
6,370452,361.7695313,485,417,902,,
6,379912,371.0078125,634,568,1202,,
6,389392,380.265625,557,468,1025,,
6,398860,389.5117188,822,745,1567,,
6,408334,398.7636719,643,564,1207,,
6,417812,408.0195313,474,402,876,,
6,427294,417.2792969,674,602,1276,,
6,436766,426.5292969,899,836,1735,,
6,446240,435.78125,684,614,1298,,
6,455712,445.03125,631,559,1190,,
6,465176,454.2734375,641,557,1198,,
6,474656,463.53125,626,527,1153,,
6,484122,472.7753906,598,517,1115,,
6,493608,482.0390625,369,294,663,,
6,503078,491.2871094,429,349,778,,
6,512548,500.5351563,754,678,1432,,
6,522018,509.7832031,711,629,1340,,
6,531510,519.0527344,748,668,1416,,
6,540978,528.2988281,652,523,1175,,
6,550456,537.5546875,639,552,1191,,
6,559932,546.8085938,571,477,1048,,
6,569412,556.0664063,591,491,1082,BAn15m5 (iteration 5),
6,10260,10.01953125,95,61,156,,
6,19740,19.27734375,81,49,130,,
6,29212,28.52734375,84,46,130,,
6,38688,37.78125,84,52,136,,
6,48164,47.03515625,89,50,139,,
6,57634,56.28320313,87,52,139,,
6,67102,65.52929688,93,55,148,,
6,76588,74.79296875,93,54,147,,
6,86072,84.0546875,94,56,150,,
6,95554,93.31445313,121,70,191,,
6,105040,102.578125,159,96,255,,
6,114516,111.8320313,144,85,229,,
6,123996,121.0898438,129,68,197,,
6,133464,130.3359375,105,58,163,,
6,142936,139.5859375,101,58,159,,
6,152414,148.8417969,115,56,171,,
6,161896,158.1015625,153,99,252,,
6,171360,167.34375,117,68,185,,
6,180842,176.6035156,1148,1097,2245,,
6,190316,185.8554688,97,52,149,,
6,199806,195.1230469,99,48,147,,
6,209274,204.3691406,120,69,189,,
6,218758,213.6308594,466,401,867,,
6,228238,222.8886719,133,82,215,,
6,237728,232.15625,128,64,192,,
6,247204,241.4101563,228,167,395,,
6,256680,250.6640625,630,567,1197,,
6,266158,259.9199219,663,601,1264,,
6,275628,269.1679688,111,56,167,,
6,285110,278.4277344,126,66,192,,
6,294574,287.6699219,159,80,239,,
6,304054,296.9277344,156,78,234,,
6,313530,306.1816406,124,44,168,,
6,323006,315.4355469,134,71,205,,
6,332490,324.6972656,582,516,1098,,
6,341954,333.9394531,775,692,1467,,
6,351434,343.1972656,181,95,276,,
6,360914,352.4550781,651,580,1231,,
6,370394,361.7128906,692,626,1318,,
6,379860,370.9570313,542,480,1022,,
6,389356,380.2304688,638,574,1212,,
6,398842,389.4941406,535,471,1006,,
6,408324,398.7539063,593,493,1086,,
6,417804,408.0117188,556,485,1041,,
6,427298,417.2832031,1208,1132,2340,,
6,436786,426.5488281,404,328,732,,
6,446262,435.8027344,530,458,988,,
6,455738,445.0566406,731,652,1383,,
6,465198,454.2949219,522,447,969,,
6,474686,463.5605469,738,662,1400,,
6,484162,472.8144531,671,579,1250,,
6,493640,482.0703125,675,585,1260,,
6,503120,491.328125,517,435,952,,
6,512594,500.5800781,699,619,1318,,
6,522068,509.8320313,602,512,1114,,
6,531550,519.0917969,706,622,1328,,
6,541024,528.34375,575,474,1049,,
6,550502,537.5996094,768,659,1427,,
6,559968,546.84375,720,631,1351,,
6,569446,556.0996094,716,612,1328,,
6,578916,565.3476563,591,488,1079,,
6,588400,574.609375,827,727,1554,,
6,597884,583.8710938,687,588,1275,,
6,607372,593.1367188,1012,921,1933,,
6,616844,602.3867188,539,415,954,,
6,626328,611.6484375,585,466,1051,,
6,635798,620.8964844,873,757,1630,,
6,645260,630.1367188,796,685,1481,,
6,654732,639.3867188,898,793,1691,,
6,664210,648.6425781,1647,1530,3177,,
6,673692,657.9023438,1544,1436,2980,,
6,683164,667.1523438,857,746,1603,,
6,692644,676.4101563,1134,1019,2153,,
6,702116,685.6601563,1153,1031,2184,,
6,711570,694.8925781,1369,1250,2619,,
6,721044,704.1445313,1078,971,2049,,
6,730550,713.4277344,893,786,1679,BAn15m7 (iteration 1),
6,10278,10.03710938,110,73,183,,
6,19736,19.2734375,101,54,155,,
6,29216,28.53125,84,50,134,,
6,38692,37.78515625,70,39,109,,
6,48164,47.03515625,88,51,139,,
6,57640,56.2890625,82,47,129,,
6,67130,65.55664063,96,62,158,,
6,76618,74.82226563,86,41,127,,
6,86100,84.08203125,97,57,154,,
6,95582,93.34179688,91,51,142,,
6,105066,102.6035156,108,84,192,,
6,114550,111.8652344,96,54,150,,
6,124026,121.1191406,104,77,181,,
6,133500,130.3710938,127,72,199,,
6,142978,139.6269531,126,76,202,,
6,152468,148.8945313,110,58,168,,
6,161948,158.1523438,785,729,1514,,
6,171422,167.4042969,259,194,453,,
6,180904,176.6640625,822,773,1595,,
6,190392,185.9296875,1017,962,1979,,
6,199868,195.1835938,128,70,198,,
6,209340,204.4335938,556,499,1055,,
6,218828,213.6992188,491,440,931,,
6,228306,222.9550781,110,41,151,,
6,237784,232.2109375,97,45,142,,
6,247264,241.46875,232,160,392,,
6,256734,250.7167969,138,74,212,,
6,266222,259.9824219,689,631,1320,,
6,275696,269.234375,853,795,1648,,
6,285174,278.4902344,109,53,162,,
6,294648,287.7421875,135,71,206,,
6,304116,296.9882813,104,50,154,,
6,313604,306.2539063,124,61,185,,
6,323082,315.5097656,124,66,190,,
6,332576,324.78125,643,576,1219,,
6,342064,334.046875,866,800,1666,,
6,351544,343.3046875,632,562,1194,,
6,361028,352.5664063,805,745,1550,,
6,370500,361.8164063,467,398,865,,
6,379976,371.0703125,715,628,1343,,
6,389454,380.3261719,666,584,1250,,
6,398948,389.5976563,701,634,1335,,
6,408430,398.8574219,484,427,911,,
6,417900,408.1054688,879,810,1689,,
6,427372,417.3554688,657,589,1246,,
6,436854,426.6152344,640,567,1207,,
6,446338,435.8769531,726,635,1361,,
6,455810,445.1269531,517,432,949,,
6,465288,454.3828125,661,583,1244,,
6,474756,463.6289063,615,533,1148,,
6,484236,472.8867188,874,781,1655,,
6,493702,482.1308594,763,670,1433,,
6,503182,491.3886719,552,462,1014,,
6,512672,500.65625,739,655,1394,,
6,522150,509.9121094,540,467,1007,,
6,531626,519.1660156,955,868,1823,,
6,541092,528.4101563,812,711,1523,,
6,550562,537.6582031,623,540,1163,,
6,560030,546.9042969,829,709,1538,,
6,569508,556.1601563,578,495,1073,,
6,578984,565.4140625,668,574,1242,,
6,588454,574.6621094,685,591,1276,,
6,597934,583.9199219,671,582,1253,,
6,607404,593.1679688,708,613,1321,,
6,616876,602.4179688,723,617,1340,,
6,626336,611.65625,871,770,1641,,
6,635810,620.9082031,631,537,1168,,
6,645294,630.1699219,840,729,1569,,
6,654768,639.421875,677,579,1256,,
6,664238,648.6699219,1699,1599,3298,,
6,673720,657.9296875,1454,1348,2802,,
6,683202,667.1894531,1291,1186,2477,,
6,692676,676.4414063,1119,1013,2132,,
6,702148,685.6914063,1157,1021,2178,,
6,711626,694.9472656,1249,1132,2381,,
6,721100,704.1992188,919,799,1718,,
6,730566,713.4433594,1007,891,1898,BAn15m7 (iteration 2),
6,10252,10.01171875,77,47,124,,
6,19738,19.27539063,93,55,148,,
6,29220,28.53515625,100,58,158,,
6,38684,37.77734375,92,49,141,,
6,48162,47.03320313,81,46,127,,
6,57642,56.29101563,85,43,128,,
6,67116,65.54296875,89,63,152,,
6,76608,74.8125,92,63,155,,
6,86092,84.07421875,89,63,152,,
6,95570,93.33007813,119,71,190,,
6,105080,102.6171875,137,82,219,,
6,114574,111.8886719,89,43,132,,
6,124046,121.1386719,166,124,290,,
6,133530,130.4003906,100,56,156,,
6,143006,139.6542969,289,248,537,,
6,152484,148.9101563,434,359,793,,
6,161956,158.1601563,114,62,176,,
6,171414,167.3964844,749,699,1448,,
6,180900,176.6601563,147,84,231,,
6,190386,185.9238281,117,63,180,,
6,199860,195.1757813,795,734,1529,,
6,209332,204.4257813,101,48,149,,
6,218808,213.6796875,116,61,177,,
6,228286,222.9355469,464,398,862,,
6,237758,232.1855469,125,53,178,,
6,247238,241.4433594,766,711,1477,,
6,256722,250.7050781,153,90,243,,
6,266206,259.9667969,152,75,227,,
6,275692,269.2304688,378,312,690,,
6,285166,278.4824219,136,77,213,,
6,294644,287.7382813,128,63,191,,
6,304110,296.9824219,125,64,189,,
6,313596,306.2460938,137,69,206,,
6,323074,315.5019531,132,65,197,,
6,332532,324.7382813,1054,986,2040,,
6,342014,333.9980469,745,663,1408,,
6,351484,343.2460938,747,681,1428,,
6,360970,352.5097656,534,466,1000,,
6,370436,361.7539063,718,651,1369,,
6,379904,371,742,676,1418,,
6,389388,380.2617188,622,555,1177,,
6,398860,389.5117188,471,396,867,,
6,408344,398.7734375,753,678,1431,,
6,417816,408.0234375,626,555,1181,,
6,427296,417.28125,485,414,899,,
6,436774,426.5371094,688,616,1304,,
6,446256,435.796875,721,642,1363,,
6,455740,445.0585938,572,495,1067,,
6,465212,454.3085938,504,417,921,,
6,474710,463.5839844,386,305,691,,
6,484186,472.8378906,786,695,1481,,
6,493666,482.0957031,1148,1061,2209,,
6,503144,491.3515625,748,652,1400,,
6,512608,500.59375,562,477,1039,,
6,522086,509.8496094,819,722,1541,,
6,531568,519.109375,578,477,1055,,
6,541044,528.3632813,640,546,1186,,
6,550518,537.6152344,655,571,1226,,
6,559984,546.859375,649,546,1195,,
6,569452,556.1054688,696,594,1290,,
6,578940,565.3710938,638,541,1179,,
6,588408,574.6171875,768,680,1448,,
6,597888,583.875,769,657,1426,,
6,607352,593.1171875,784,681,1465,,
6,616818,602.3613281,807,713,1520,,
6,626292,611.6132813,803,704,1507,,
6,635760,620.859375,623,520,1143,,
6,645240,630.1171875,836,722,1558,,
6,654720,639.375,647,532,1179,,
6,664190,648.6230469,1753,1607,3360,,
6,673680,657.890625,1316,1199,2515,,
6,683164,667.1523438,1060,945,2005,,
6,692636,676.4023438,1137,1024,2161,,
6,702120,685.6640625,1385,1250,2635,,
6,711590,694.9121094,903,798,1701,,
6,721076,704.1757813,1375,1274,2649,BAn15m7 (iteration 3),
6,10268,10.02734375,107,70,177,,
6,19738,19.27539063,109,63,172,,
6,29222,28.53710938,105,65,170,,
6,38706,37.79882813,123,72,195,,
6,48184,47.0546875,114,67,181,,
6,57666,56.31445313,119,74,193,,
6,67142,65.56835938,98,59,157,,
6,76614,74.81835938,103,59,162,,
6,86098,84.08007813,99,55,154,,
6,95582,93.34179688,117,66,183,,
6,105062,102.5996094,130,72,202,,
6,114558,111.8730469,103,54,157,,
6,124044,121.1367188,104,60,164,,
6,133526,130.3964844,104,58,162,,
6,143004,139.6523438,103,57,160,,
6,152478,148.9042969,100,53,153,,
6,161954,158.1582031,273,206,479,,
6,171430,167.4121094,108,63,171,,
6,180910,176.6699219,1566,1517,3083,,
6,190388,185.9257813,214,168,382,,
6,199864,195.1796875,137,87,224,,
6,209342,204.4355469,140,93,233,,
6,218822,213.6933594,611,567,1178,,
6,228296,222.9453125,123,66,189,,
6,237770,232.1972656,104,54,158,,
6,247236,241.4414063,231,169,400,,
6,256716,250.6992188,546,473,1019,,
6,266198,259.9589844,595,524,1119,,
6,275684,269.2226563,108,49,157,,
6,285146,278.4628906,125,64,189,,
6,294618,287.7128906,128,52,180,,
6,304110,296.9824219,120,59,179,,
6,313574,306.2246094,101,49,150,,
6,323040,315.46875,129,50,179,,
6,332510,324.7167969,623,555,1178,,
6,341998,333.9824219,789,719,1508,,
6,351478,343.2402344,709,642,1351,,
6,360956,352.4960938,950,870,1820,,
6,370436,361.7539063,525,461,986,,
6,379908,371.0039063,707,643,1350,,
6,389374,380.2480469,682,603,1285,,
6,398858,389.5097656,408,333,741,,
6,408340,398.7695313,591,526,1117,,
6,417810,408.0175781,681,609,1290,,
6,427290,417.2753906,685,612,1297,,
6,436772,426.5351563,524,429,953,,
6,446242,435.7832031,724,651,1375,,
6,455728,445.046875,704,628,1332,,
6,465204,454.3007813,687,617,1304,,
6,474692,463.5664063,964,889,1853,,
6,484176,472.828125,306,227,533,,
6,493646,482.0761719,605,491,1096,,
6,503122,491.3300781,737,649,1386,,
6,512600,500.5859375,669,583,1252,,
6,522098,509.8613281,805,718,1523,,
6,531580,519.1210938,538,460,998,,
6,541058,528.3769531,755,664,1419,,
6,550528,537.625,797,687,1484,,
6,560004,546.8789063,747,661,1408,,
6,569488,556.140625,878,782,1660,,
6,578956,565.3867188,638,513,1151,,
6,588420,574.6289063,911,821,1732,,
6,597890,583.8769531,552,458,1010,,
6,607360,593.125,793,701,1494,,
6,616834,602.3769531,785,692,1477,,
6,626294,611.6152344,851,735,1586,,
6,635770,620.8691406,841,740,1581,,
6,645254,630.1308594,570,439,1009,,
6,654746,639.4003906,935,821,1756,,
6,664214,648.6464844,1744,1643,3387,,
6,673694,657.9042969,1302,1204,2506,,
6,683176,667.1640625,1263,1162,2425,,
6,692652,676.4179688,1167,1029,2196,,
6,702134,685.6777344,906,795,1701,,
6,711602,694.9238281,1361,1245,2606,,
6,721074,704.1738281,1099,1001,2100,,
6,730546,713.4238281,994,883,1877,BAn15m7 (iteration 4),
6,10266,10.02539063,85,39,124,,
6,19740,19.27734375,98,45,143,,
6,29216,28.53125,85,51,136,,
6,38704,37.796875,84,52,136,,
6,48172,47.04296875,99,59,158,,
6,57634,56.28320313,101,62,163,,
6,67118,65.54492188,93,56,149,,
6,76572,74.77734375,93,56,149,,
6,86050,84.03320313,93,54,147,,
6,95530,93.29101563,92,55,147,,
6,105014,102.5527344,106,54,160,,
6,114494,111.8105469,102,61,163,,
6,123970,121.0644531,113,65,178,,
6,133438,130.3105469,92,52,144,,
6,142918,139.5683594,96,53,149,,
6,152400,148.828125,96,39,135,,
6,161882,158.0878906,113,56,169,,
6,171364,167.3476563,381,334,715,,
6,180844,176.6054688,1606,1551,3157,,
6,190314,185.8535156,300,251,551,,
6,199796,195.1132813,159,110,269,,
6,209264,204.359375,233,178,411,,
6,218748,213.6210938,540,479,1019,,
6,228210,222.8613281,116,69,185,,
6,237678,232.1074219,170,100,270,,
6,247156,241.3632813,656,588,1244,,
6,256618,250.6035156,122,67,189,,
6,266078,259.8417969,312,254,566,,
6,275558,269.0996094,102,48,150,,
6,285026,278.3457031,113,66,179,,
6,294508,287.6054688,165,78,243,,
6,303980,296.8554688,127,64,191,,
6,313454,306.1074219,776,713,1489,,
6,322930,315.3613281,110,51,161,,
6,332424,324.6328125,982,909,1891,,
6,341906,333.8925781,621,555,1176,,
6,351372,343.1367188,761,675,1436,,
6,360830,352.3730469,699,628,1327,,
6,370310,361.6308594,467,404,871,,
6,379786,370.8847656,968,903,1871,,
6,389252,380.1289063,538,468,1006,,
6,398722,389.3769531,738,656,1394,,
6,408206,398.6386719,703,626,1329,,
6,417690,407.9003906,679,609,1288,,
6,427158,417.1464844,714,645,1359,,
6,436630,426.3964844,589,517,1106,,
6,446104,435.6484375,571,490,1061,,
6,455588,444.9101563,537,444,981,,
6,465072,454.171875,716,642,1358,,
6,474550,463.4277344,799,722,1521,,
6,484018,472.6738281,769,696,1465,,
6,493494,481.9277344,688,605,1293,,
6,502972,491.1835938,612,517,1129,,
6,512452,500.4414063,771,695,1466,,
6,521928,509.6953125,549,474,1023,,
6,531394,518.9394531,729,642,1371,,
6,540862,528.1855469,673,573,1246,,
6,550348,537.4492188,1226,1108,2334,,
6,559832,546.7109375,378,300,678,,
6,569316,555.9726563,539,460,999,,
6,578798,565.2324219,869,766,1635,,
6,588272,574.484375,743,655,1398,,
6,597750,583.7402344,885,801,1686,,
6,607216,592.984375,1655,1563,3218,,
6,616682,602.2285156,316,200,516,,
6,626186,611.5097656,727,612,1339,,
6,635656,620.7578125,839,721,1560,,
6,645136,630.015625,806,688,1494,,
6,654620,639.2773438,787,679,1466,,
6,664090,648.5253906,1903,1797,3700,,
6,673568,657.78125,1279,1173,2452,,
6,683034,667.0253906,1128,1020,2148,,
6,692490,676.2597656,1241,1125,2366,,
6,701964,685.5117188,978,870,1848,,
6,711440,694.765625,1363,1254,2617,,
6,720914,704.0175781,948,817,1765,,
6,730386,713.2675781,1352,1247,2599,BAn15m7 (iteration 5),
6,10266,10.02539063,76,45,121,,
6,19756,19.29296875,85,48,133,,
6,29232,28.546875,80,48,128,,
6,38694,37.78710938,81,48,129,,
6,48176,47.046875,85,52,137,,
6,57656,56.3046875,96,57,153,,
6,67126,65.55273438,89,50,139,,
6,76602,74.80664063,86,50,136,,
6,86086,84.06835938,86,51,137,,
6,95542,93.30273438,78,41,119,,
6,105028,102.5664063,107,81,188,,
6,114482,111.7988281,98,58,156,,
6,123956,121.0507813,94,55,149,,
6,133434,130.3066406,97,56,153,,
6,142918,139.5683594,106,64,170,,
6,152398,148.8261719,99,48,147,,
6,161880,158.0859375,98,54,152,,
6,171348,167.3320313,100,54,154,,
6,180818,176.5800781,97,54,151,,
6,190302,185.8417969,962,910,1872,,
6,199776,195.09375,1140,1094,2234,,
6,209264,204.359375,92,44,136,,
6,218748,213.6210938,102,55,157,,
6,228234,222.8847656,100,54,154,,
6,237718,232.1464844,104,45,149,,
6,247198,241.4042969,134,73,207,,
6,256678,250.6621094,148,67,215,,
6,266150,259.9121094,625,546,1171,,
6,275628,269.1679688,103,48,151,,
6,285112,278.4296875,127,62,189,,
6,294594,287.6894531,123,61,184,,
6,304076,296.9492188,891,834,1725,,
6,313552,306.203125,837,769,1606,,
6,323028,315.4570313,454,386,840,,
6,332494,324.7011719,506,441,947,,
6,341972,333.9570313,550,473,1023,,
6,351452,343.2148438,531,467,998,,
6,360914,352.4550781,515,440,955,,
6,370392,361.7109375,507,443,950,,
6,379874,370.9707031,444,380,824,,
6,389344,380.21875,506,431,937,,
6,398822,389.4746094,479,396,875,,
6,408292,398.7226563,599,524,1123,,
6,417778,407.9863281,457,370,827,,
6,427264,417.25,561,489,1050,,
6,436734,426.4980469,619,508,1127,,
6,446212,435.7539063,633,509,1142,,
6,455684,445.0039063,651,536,1187,,
6,465164,454.2617188,667,590,1257,,
6,474630,463.5058594,640,546,1186,,
6,484124,472.7773438,733,636,1369,,
6,493600,482.03125,861,753,1614,,
6,503082,491.2910156,1207,1125,2332,,
6,512558,500.5449219,283,204,487,,
6,522044,509.8085938,1472,1366,2838,,
6,531520,519.0625,427,333,760,,
6,540998,528.3183594,514,421,935,,
6,550472,537.5703125,674,572,1246,,
6,559956,546.8320313,700,595,1295,,
6,569432,556.0859375,542,434,976,,
6,578902,565.3339844,789,692,1481,,
6,588376,574.5859375,718,622,1340,,
6,597844,583.8320313,782,696,1478,,
6,607308,593.0742188,655,563,1218,,
6,616786,602.3300781,787,695,1482,,
6,626266,611.5878906,548,432,980,,
6,635746,620.8457031,874,777,1651,,
6,645204,630.0820313,881,779,1660,,
6,654666,639.3222656,589,479,1068,,
6,664150,648.5839844,1897,1797,3694,,
6,673634,657.8457031,1837,1735,3572,,
6,683116,667.1054688,1108,1012,2120,,
6,692602,676.3691406,1494,1394,2888,,
6,702064,685.609375,1161,1050,2211,,
6,711542,694.8652344,1578,1458,3036,,
6,721032,704.1328125,1266,1155,2421,,
6,730500,713.3789063,1211,1092,2303,,
6,739982,722.6386719,1478,1354,2832,,
6,749468,731.9023438,1108,987,2095,,
6,758958,741.1699219,1527,1407,2934,,
6,768430,750.4199219,1112,995,2107,,
6,777884,759.6523438,1835,1701,3536,,
6,787332,768.8789063,1328,1218,2546,,
6,796818,778.1425781,1371,1256,2627,,
6,806286,787.3886719,1378,1257,2635,,
6,815766,796.6464844,1002,876,1878,,
6,825242,805.9003906,1292,1165,2457,,
6,834740,815.1757813,1556,1432,2988,,
6,844206,824.4199219,823,700,1523,,
6,853670,833.6621094,1228,1073,2301,,
6,863146,842.9160156,1468,1305,2773,,
6,872616,852.1640625,951,814,1765,,
6,882100,861.4257813,1493,1365,2858,,
6,891576,870.6796875,1251,1104,2355,,
6,901048,879.9296875,1375,1198,2573,BAn15m10 (iteration 1),
6,10270,10.02929688,87,53,140,,
6,19742,19.27929688,98,60,158,,
6,29214,28.52929688,102,55,157,,
6,38700,37.79296875,81,46,127,,
6,48188,47.05859375,86,51,137,,
6,57670,56.31835938,84,50,134,,
6,67160,65.5859375,99,62,161,,
6,76624,74.828125,85,43,128,,
6,86102,84.08398438,83,48,131,,
6,95588,93.34765625,91,54,145,,
6,105066,102.6035156,94,54,148,,
6,114542,111.8574219,103,66,169,,
6,124022,121.1152344,84,43,127,,
6,133514,130.3847656,91,50,141,,
6,142978,139.6269531,98,54,152,,
6,152452,148.8789063,86,42,128,,
6,161934,158.1386719,95,54,149,,
6,171392,167.375,105,60,165,,
6,180854,176.6152344,107,58,165,,
6,190318,185.8574219,1958,1903,3861,,
6,199800,195.1171875,1096,1040,2136,,
6,209268,204.3632813,731,650,1381,,
6,218730,213.6035156,114,54,168,,
6,228200,222.8515625,120,56,176,,
6,237684,232.1132813,114,51,165,,
6,247162,241.3691406,168,89,257,,
6,256636,250.6210938,167,75,242,,
6,266120,259.8828125,173,110,283,,
6,275596,269.1367188,541,471,1012,,
6,285060,278.3789063,110,56,166,,
6,294546,287.6425781,136,76,212,,
6,304010,296.8847656,1035,981,2016,,
6,313486,306.1386719,857,787,1644,,
6,322960,315.390625,520,454,974,,
6,332438,324.6464844,644,562,1206,,
6,341906,333.8925781,495,424,919,,
6,351382,343.1464844,618,556,1174,,
6,360860,352.4023438,449,382,831,,
6,370342,361.6621094,358,278,636,,
6,379820,370.9179688,515,433,948,,
6,389310,380.1855469,493,418,911,,
6,398786,389.4394531,488,412,900,,
6,408278,398.7089844,586,510,1096,,
6,417748,407.9570313,601,525,1126,,
6,427234,417.2207031,606,522,1128,,
6,436704,426.46875,591,518,1109,,
6,446184,435.7265625,634,553,1187,,
6,455672,444.9921875,665,578,1243,,
6,465154,454.2519531,619,537,1156,,
6,474630,463.5058594,543,449,992,,
6,484110,472.7636719,736,649,1385,,
6,493574,482.0058594,1012,931,1943,,
6,503050,491.2597656,1151,1064,2215,,
6,512528,500.515625,285,197,482,,
6,522016,509.78125,1422,1336,2758,,
6,531486,519.0292969,465,366,831,,
6,540968,528.2890625,799,686,1485,,
6,550460,537.5585938,483,395,878,,
6,559938,546.8144531,870,754,1624,,
6,569404,556.0585938,686,607,1293,,
6,578878,565.3105469,616,531,1147,,
6,588358,574.5683594,753,669,1422,,
6,597842,583.8300781,744,660,1404,,
6,607322,593.0878906,671,573,1244,,
6,616786,602.3300781,645,544,1189,,
6,626264,611.5859375,1448,1355,2803,,
6,635756,620.8554688,459,354,813,,
6,645218,630.0957031,775,684,1459,,
6,654694,639.3496094,846,726,1572,,
6,664168,648.6015625,1679,1580,3259,,
6,673644,657.8554688,1589,1487,3076,,
6,683124,667.1132813,1348,1246,2594,,
6,692604,676.3710938,1504,1406,2910,,
6,702072,685.6171875,1856,1733,3589,,
6,711530,694.8535156,1339,1232,2571,,
6,721006,704.1074219,1385,1270,2655,,
6,730482,713.3613281,1168,1051,2219,,
6,739968,722.625,1612,1491,3103,,
6,749450,731.8847656,1379,1254,2633,,
6,758932,741.1445313,1429,1325,2754,,
6,768406,750.3964844,1414,1299,2713,,
6,777888,759.65625,1207,1063,2270,,
6,787360,768.90625,1377,1269,2646,,
6,796816,778.140625,1269,1157,2426,,
6,806290,787.3925781,1475,1340,2815,,
6,815766,796.6464844,1528,1366,2894,,
6,825242,805.9003906,1213,1089,2302,,
6,834724,815.1601563,1223,1099,2322,,
6,844192,824.40625,1201,1075,2276,,
6,853672,833.6640625,1267,1118,2385,,
6,863158,842.9277344,1201,1081,2282,,
6,872638,852.1855469,1207,1082,2289,,
6,882116,861.4414063,952,823,1775,,
6,891592,870.6953125,1259,1128,2387,,
6,901062,879.9433594,1477,1350,2827,BAn15m10 (iteration 2),
6,10264,10.0234375,78,50,128,,
6,19736,19.2734375,84,44,128,,
6,29212,28.52734375,96,67,163,,
6,38694,37.78710938,123,90,213,,
6,48174,47.04492188,147,106,253,,
6,57654,56.30273438,104,56,160,,
6,67126,65.55273438,100,59,159,,
6,76612,74.81640625,90,55,145,,
6,86098,84.08007813,97,58,155,,
6,95580,93.33984375,93,55,148,,
6,105048,102.5859375,94,54,148,,
6,114532,111.8476563,98,57,155,,
6,124006,121.0996094,97,56,153,,
6,133488,130.359375,106,59,165,,
6,142960,139.609375,107,64,171,,
6,152442,148.8691406,110,63,173,,
6,161918,158.1230469,102,59,161,,
6,171384,167.3671875,106,58,164,,
6,180868,176.6289063,120,62,182,,
6,190336,185.875,2792,2733,5525,,
6,199810,195.1269531,784,738,1522,,
6,209292,204.3867188,391,335,726,,
6,218764,213.6367188,439,387,826,,
6,228248,222.8984375,108,58,166,,
6,237720,232.1484375,113,62,175,,
6,247192,241.3984375,111,59,170,,
6,256684,250.6679688,124,62,186,,
6,266158,259.9199219,892,833,1725,,
6,275638,269.1777344,166,100,266,,
6,285128,278.4453125,221,165,386,,
6,294614,287.7089844,138,72,210,,
6,304096,296.96875,1396,1312,2708,,
6,313582,306.2324219,816,754,1570,,
6,323044,315.4726563,783,705,1488,,
6,332524,324.7304688,539,478,1017,,
6,342004,333.9882813,483,407,890,,
6,351476,343.2382813,673,579,1252,,
6,360952,352.4921875,519,457,976,,
6,370420,361.7382813,459,402,861,,
6,379892,370.9882813,593,530,1123,,
6,389376,380.25,428,355,783,,
6,398862,389.5136719,558,490,1048,,
6,408340,398.7695313,589,520,1109,,
6,417818,408.0253906,543,465,1008,,
6,427294,417.2792969,537,472,1009,,
6,436770,426.5332031,732,652,1384,,
6,446238,435.7792969,647,563,1210,,
6,455710,445.0292969,632,544,1176,,
6,465182,454.2792969,495,413,908,,
6,474650,463.5253906,611,531,1142,,
6,484136,472.7890625,836,756,1592,,
6,493618,482.0488281,958,871,1829,,
6,503090,491.2988281,1326,1235,2561,,
6,512560,500.546875,213,140,353,,
6,522046,509.8105469,1431,1337,2768,,
6,531530,519.0722656,1043,966,2009,,
6,541010,528.3300781,272,185,457,,
6,550488,537.5859375,807,723,1530,,
6,559976,546.8515625,855,772,1627,,
6,569454,556.1074219,851,736,1587,,
6,578936,565.3671875,592,504,1096,,
6,588414,574.6230469,832,721,1553,,
6,597906,583.8925781,746,620,1366,,
6,607384,593.1484375,819,735,1554,,
6,616864,602.40625,669,575,1244,,
6,626332,611.6523438,869,780,1649,,
6,635820,620.9179688,886,770,1656,,
6,645294,630.1699219,870,765,1635,,
6,654756,639.4101563,698,607,1305,,
6,664230,648.6621094,2011,1917,3928,,
6,673716,657.9257813,1877,1772,3649,,
6,683194,667.1816406,1320,1226,2546,,
6,692662,676.4277344,1213,1111,2324,,
6,702134,685.6777344,1576,1473,3049,,
6,711600,694.921875,1268,1150,2418,,
6,721072,704.171875,1449,1332,2781,,
6,730540,713.4179688,1583,1469,3052,,
6,740016,722.671875,1230,1110,2340,,
6,749496,731.9296875,1645,1539,3184,,
6,758972,741.1835938,1419,1304,2723,,
6,768456,750.4453125,1387,1280,2667,,
6,777932,759.6992188,1520,1379,2899,,
6,787402,768.9472656,1155,1045,2200,,
6,796888,778.2109375,1615,1492,3107,,
6,806360,787.4609375,1457,1331,2788,,
6,815834,796.7128906,971,833,1804,,
6,825322,805.9785156,1481,1364,2845,,
6,834802,815.2363281,1206,1076,2282,,
6,844276,824.4882813,1190,1069,2259,,
6,853750,833.7402344,1241,1092,2333,,
6,863228,842.9960938,1118,983,2101,,
6,872710,852.2558594,978,857,1835,,
6,882184,861.5078125,1211,1073,2284,,
6,891650,870.7519531,1662,1535,3197,,
6,901124,880.0039063,906,766,1672,BAn15m10 (iteration 3),
6,10282,10.04101563,82,50,132,,
6,19750,19.28710938,110,73,183,,
6,29216,28.53125,85,53,138,,
6,38686,37.77929688,84,50,134,,
6,48160,47.03125,85,53,138,,
6,57632,56.28125,86,51,137,,
6,67108,65.53515625,82,46,128,,
6,76590,74.79492188,86,49,135,,
6,86056,84.0390625,84,50,134,,
6,95530,93.29101563,80,45,125,,
6,104996,102.5351563,92,53,145,,
6,114462,111.7792969,100,61,161,,
6,123938,121.0332031,84,47,131,,
6,133408,130.28125,150,80,230,,
6,142886,139.5371094,100,50,150,,
6,152362,148.7910156,116,72,188,,
6,161828,158.0351563,112,57,169,,
6,171300,167.2851563,93,51,144,,
6,180778,176.5410156,84,43,127,,
6,190260,185.8007813,2169,2121,4290,,
6,199746,195.0644531,861,809,1670,,
6,209234,204.3300781,639,591,1230,,
6,218686,213.5605469,107,59,166,,
6,228162,222.8144531,106,57,163,,
6,237618,232.0488281,115,62,177,,
6,247090,241.2988281,130,73,203,,
6,256572,250.5585938,122,64,186,,
6,266036,259.8007813,279,228,507,,
6,275514,269.0566406,500,420,920,,
6,284988,278.3085938,126,65,191,,
6,294478,287.5761719,115,57,172,,
6,303938,296.8144531,959,906,1865,,
6,313402,306.0566406,818,752,1570,,
6,322882,315.3144531,623,558,1181,,
6,332350,324.5605469,538,464,1002,,
6,341832,333.8203125,565,502,1067,,
6,351320,343.0859375,516,456,972,,
6,360796,352.3398438,545,477,1022,,
6,370286,361.6074219,551,467,1018,,
6,379774,370.8730469,485,421,906,,
6,389258,380.1347656,565,499,1064,,
6,398740,389.3945313,554,472,1026,,
6,408220,398.6523438,594,502,1096,,
6,417692,407.9023438,656,571,1227,,
6,427172,417.1601563,623,545,1168,,
6,436644,426.4101563,518,436,954,,
6,446112,435.65625,720,639,1359,,
6,455598,444.9199219,583,509,1092,,
6,465060,454.1601563,642,538,1180,,
6,474540,463.4179688,486,407,893,,
6,484012,472.6679688,767,691,1458,,
6,493492,481.9257813,925,840,1765,,
6,502968,491.1796875,1052,957,2009,,
6,512456,500.4453125,510,428,938,,
6,521928,509.6953125,1583,1476,3059,,
6,531410,518.9550781,433,346,779,,
6,540880,528.203125,697,607,1304,,
6,550362,537.4628906,462,382,844,,
6,559842,546.7207031,770,682,1452,,
6,569316,555.9726563,529,446,975,,
6,578792,565.2265625,821,727,1548,,
6,588270,574.4824219,764,673,1437,,
6,597764,583.7539063,522,431,953,,
6,607256,593.0234375,799,711,1510,,
6,616732,602.2773438,796,698,1494,,
6,626212,611.5351563,1135,1023,2158,,
6,635694,620.7949219,567,457,1024,,
6,645156,630.0351563,802,697,1499,,
6,654660,639.3164063,861,757,1618,,
6,664136,648.5703125,1626,1533,3159,,
6,673610,657.8222656,1691,1595,3286,,
6,683094,667.0839844,1209,1102,2311,,
6,692572,676.3398438,1629,1520,3149,,
6,702058,685.6035156,1353,1250,2603,,
6,711530,694.8535156,1098,990,2088,,
6,721008,704.109375,1398,1291,2689,,
6,730484,713.3632813,1322,1214,2536,,
6,739952,722.609375,1395,1254,2649,,
6,749426,731.8613281,1443,1328,2771,,
6,758908,741.1210938,1393,1285,2678,,
6,768378,750.3691406,1568,1454,3022,,
6,777852,759.6210938,1198,1078,2276,,
6,787336,768.8828125,1702,1583,3285,,
6,796798,778.1230469,1175,1065,2240,,
6,806280,787.3828125,1498,1370,2868,,
6,815744,796.625,1426,1285,2711,,
6,825216,805.875,996,873,1869,,
6,834718,815.1542969,1192,1072,2264,,
6,844208,824.421875,1472,1345,2817,,
6,853692,833.6835938,1249,1112,2361,,
6,863166,842.9355469,1334,1187,2521,,
6,872652,852.1992188,813,676,1489,,
6,882130,861.4550781,1220,1082,2302,,
6,891606,870.7089844,1514,1378,2892,,
6,901096,879.9765625,1225,1072,2297,BAn15m10 (iteration 4),
6,10266,10.02539063,92,55,147,,
6,19742,19.27929688,133,80,213,,
6,29222,28.53710938,107,63,170,,
6,38694,37.78710938,110,52,162,,
6,48166,47.03710938,85,50,135,,
6,57656,56.3046875,87,49,136,,
6,67132,65.55859375,101,57,158,,
6,76620,74.82421875,100,49,149,,
6,86108,84.08984375,83,50,133,,
6,95574,93.33398438,91,45,136,,
6,105030,102.5683594,88,49,137,,
6,114514,111.8300781,95,57,152,,
6,124000,121.09375,101,59,160,,
6,133468,130.3398438,98,55,153,,
6,142954,139.6035156,97,41,138,,
6,152432,148.859375,96,55,151,,
6,161900,158.1054688,89,49,138,,
6,171362,167.3457031,90,49,139,,
6,180850,176.6113281,108,61,169,,
6,190332,185.8710938,2930,2877,5807,,
6,199810,195.1269531,1126,1063,2189,,
6,209280,204.375,442,387,829,,
6,218760,213.6328125,490,437,927,,
6,228240,222.890625,100,50,150,,
6,237712,232.140625,104,51,155,,
6,247188,241.3945313,122,59,181,,
6,256666,250.6503906,131,71,202,,
6,266142,259.9042969,585,534,1119,,
6,275610,269.1503906,151,95,246,,
6,285082,278.4003906,239,170,409,,
6,294558,287.6542969,111,59,170,,
6,304028,296.9023438,1057,983,2040,,
6,313498,306.1503906,884,826,1710,,
6,322974,315.4042969,569,513,1082,,
6,332458,324.6660156,512,450,962,,
6,341936,333.921875,536,476,1012,,
6,351416,343.1796875,520,455,975,,
6,360890,352.4316406,617,549,1166,,
6,370360,361.6796875,521,455,976,,
6,379844,370.9414063,500,438,938,,
6,389326,380.2011719,426,354,780,,
6,398804,389.4570313,559,493,1052,,
6,408274,398.7050781,624,543,1167,,
6,417760,407.96875,591,519,1110,,
6,427244,417.2304688,581,514,1095,,
6,436708,426.4726563,551,470,1021,,
6,446172,435.7148438,576,505,1081,,
6,455644,444.9648438,627,511,1138,,
6,465130,454.2285156,483,359,842,,
6,474618,463.4941406,630,532,1162,,
6,484104,472.7578125,1078,980,2058,,
6,493594,482.0253906,906,803,1709,,
6,503068,491.2773438,1255,1171,2426,,
6,512548,500.5351563,413,333,746,,
6,522036,509.8007813,839,744,1583,,
6,531518,519.0605469,366,277,643,,
6,540998,528.3183594,1027,941,1968,,
6,550474,537.5722656,490,408,898,,
6,559946,546.8222656,505,420,925,,
6,569428,556.0820313,851,759,1610,,
6,578896,565.328125,760,682,1442,,
6,588372,574.5820313,839,753,1592,,
6,597870,583.8574219,638,539,1177,,
6,607344,593.109375,885,795,1680,,
6,616838,602.3808594,711,593,1304,,
6,626322,611.6425781,704,609,1313,,
6,635804,620.9023438,851,728,1579,,
6,645278,630.1542969,874,777,1651,,
6,654760,639.4140625,702,610,1312,,
6,664240,648.671875,2033,1924,3957,,
6,673720,657.9296875,1558,1464,3022,,
6,683192,667.1796875,1609,1509,3118,,
6,692672,676.4375,1371,1268,2639,,
6,702154,685.6972656,1221,1092,2313,,
6,711634,694.9550781,1360,1257,2617,,
6,721116,704.2148438,1460,1353,2813,,
6,730586,713.4628906,1387,1282,2669,,
6,740056,722.7109375,1358,1223,2581,,
6,749520,731.953125,1335,1224,2559,,
6,759018,741.2285156,1423,1315,2738,,
6,768480,750.46875,1204,1087,2291,,
6,777942,759.7089844,1413,1298,2711,,
6,787428,768.9726563,1597,1480,3077,,
6,796892,778.2148438,1427,1308,2735,,
6,806366,787.4667969,1500,1388,2888,,
6,815840,796.71875,1137,1023,2160,,
6,825328,805.984375,1072,952,2024,,
6,834780,815.2148438,1434,1293,2727,,
6,844252,824.4648438,1005,868,1873,,
6,853742,833.7324219,1171,1050,2221,,
6,863206,842.9746094,1191,1051,2242,,
6,872668,852.2148438,1280,1153,2433,,
6,882140,861.4648438,1609,1483,3092,,
6,891620,870.7226563,935,794,1729,,
6,901098,879.9785156,1487,1332,2819,BAn15m10 (iteration 5),
10,15166,14.81054688,137,90,227,,
10,29550,28.85742188,149,96,245,,
10,43934,42.90429688,143,82,225,,
10,58312,56.9453125,147,100,247,,
10,72688,70.984375,155,69,224,,
10,87052,85.01171875,157,85,242,,
10,101424,99.046875,168,105,273,,
10,115796,113.0820313,144,85,229,,
10,130166,127.1152344,156,83,239,,
10,144544,141.15625,206,116,322,,
10,158904,155.1796875,203,104,307,,
10,173300,169.2382813,877,797,1674,,
10,187664,183.265625,155,82,237,,
10,202040,197.3046875,175,83,258,,
10,216412,211.3398438,185,99,284,,
10,230788,225.3789063,179,103,282,,
10,245162,239.4160156,205,92,297,,
10,259550,253.4667969,301,228,529,,
10,273930,267.5097656,216,111,327,,
10,288300,281.5429688,184,100,284,,
10,302678,295.5839844,536,407,943,,
10,317046,309.6152344,598,523,1121,,
10,331416,323.6484375,334,222,556,,
10,345792,337.6875,488,394,882,,
10,360170,351.7285156,563,481,1044,,
10,374550,365.7714844,394,298,692,,
10,388940,379.8242188,683,570,1253,BAn15m2 (iteration 1),
10,15168,14.8125,122,80,202,,
10,29538,28.84570313,157,93,250,,
10,43910,42.88085938,143,91,234,,
10,58294,56.92773438,119,66,185,,
10,72672,70.96875,143,104,247,,
10,87044,85.00390625,159,98,257,,
10,101418,99.04101563,136,87,223,,
10,115786,113.0722656,162,98,260,,
10,130166,127.1152344,142,84,226,,
10,144532,141.1445313,182,108,290,,
10,158906,155.1816406,144,86,230,,
10,173266,169.2050781,179,95,274,,
10,187642,183.2441406,498,417,915,,
10,202028,197.2929688,167,99,266,,
10,216396,211.3242188,147,74,221,,
10,230770,225.3613281,220,124,344,,
10,245158,239.4121094,186,100,286,,
10,259538,253.4550781,210,106,316,,
10,273916,267.4960938,222,116,338,,
10,288296,281.5390625,228,115,343,,
10,302672,295.578125,184,89,273,,
10,317036,309.6054688,1362,1287,2649,,
10,331412,323.6445313,774,683,1457,,
10,345790,337.6855469,452,380,832,,
10,360148,351.7070313,424,342,766,,
10,374538,365.7597656,428,334,762,,
10,388924,379.8085938,516,432,948,BAn15m2 (iteration 2),
10,15180,14.82421875,154,82,236,,
10,29562,28.86914063,135,88,223,,
10,43942,42.91210938,155,111,266,,
10,58332,56.96484375,144,93,237,,
10,72708,71.00390625,148,85,233,,
10,87084,85.04296875,144,92,236,,
10,101458,99.08007813,139,85,224,,
10,115844,113.1289063,172,106,278,,
10,130232,127.1796875,139,88,227,,
10,144612,141.2226563,150,96,246,,
10,158980,155.2539063,146,79,225,,
10,173352,169.2890625,739,680,1419,,
10,187726,183.3261719,160,97,257,,
10,202102,197.3652344,126,69,195,,
10,216488,211.4140625,154,99,253,,
10,230848,225.4375,350,279,629,,
10,245222,239.4746094,180,103,283,,
10,259586,253.5019531,247,130,377,,
10,273958,267.5371094,201,117,318,,
10,288342,281.5839844,794,718,1512,,
10,302720,295.625,168,95,263,,
10,317092,309.6601563,464,382,846,,
10,331470,323.7011719,484,377,861,,
10,345846,337.7402344,206,116,322,,
10,360212,351.7695313,544,431,975,,
10,374596,365.8164063,657,568,1225,,
10,388978,379.8613281,592,500,1092,BAn15m2 (iteration 3),
10,15178,14.82226563,120,75,195,,
10,29564,28.87109375,158,107,265,,
10,43936,42.90625,164,117,281,,
10,58314,56.94726563,118,82,200,,
10,72684,70.98046875,138,87,225,,
10,87056,85.015625,138,87,225,,
10,101434,99.05664063,126,83,209,,
10,115818,113.1035156,141,89,230,,
10,130198,127.1464844,138,87,225,,
10,144582,141.1933594,142,86,228,,
10,158952,155.2265625,131,79,210,,
10,173322,169.2597656,809,755,1564,,
10,187706,183.3066406,145,89,234,,
10,202080,197.34375,147,86,233,,
10,216466,211.3925781,138,76,214,,
10,230848,225.4375,172,80,252,,
10,245236,239.4882813,180,99,279,,
10,259614,253.5292969,152,87,239,,
10,273994,267.5722656,181,86,267,,
10,288368,281.609375,155,81,236,,
10,302734,295.6386719,185,114,299,,
10,317122,309.6894531,1740,1649,3389,,
10,331488,323.71875,256,167,423,,
10,345864,337.7578125,433,326,759,,
10,360226,351.7832031,500,398,898,,
10,374596,365.8164063,466,376,842,,
10,388968,379.8515625,449,352,801,BAn15m2 (iteration 4),
10,15160,14.8046875,126,82,208,,
10,29552,28.859375,115,74,189,,
10,43934,42.90429688,129,81,210,,
10,58302,56.93554688,190,88,278,,
10,72680,70.9765625,123,82,205,,
10,87056,85.015625,129,67,196,,
10,101428,99.05078125,116,68,184,,
10,115810,113.0957031,135,89,224,,
10,130196,127.1445313,124,77,201,,
10,144566,141.1777344,141,75,216,,
10,158938,155.2128906,155,92,247,,
10,173324,169.2617188,610,536,1146,,
10,187690,183.2910156,130,79,209,,
10,202080,197.34375,805,737,1542,,
10,216454,211.3808594,138,81,219,,
10,230830,225.4199219,152,89,241,,
10,245208,239.4609375,212,142,354,,
10,259578,253.4941406,329,249,578,,
10,273940,267.5195313,148,88,236,,
10,288312,281.5546875,165,96,261,,
10,302690,295.5957031,173,83,256,,
10,317072,309.640625,639,562,1201,,
10,331462,323.6933594,1020,933,1953,,
10,345840,337.734375,672,595,1267,,
10,360210,351.7675781,461,384,845,,
10,374576,365.796875,571,465,1036,,
10,388940,379.8242188,437,352,789,BAn15m2 (iteration 5),
10,15172,14.81640625,122,70,192,,
10,29554,28.86132813,131,80,211,,
10,43932,42.90234375,115,72,187,,
10,58318,56.95117188,123,76,199,,
10,72702,70.99804688,131,85,216,,
10,87780,85.72265625,356,97,453,,
10,102152,99.7578125,142,88,230,,
10,116532,113.8007813,131,84,215,,
10,130904,127.8359375,131,81,212,,
10,145288,141.8828125,138,96,234,,
10,159672,155.9296875,134,87,221,,
10,174048,169.96875,137,69,206,,
10,188426,184.0097656,181,108,289,,
10,202804,198.0507813,147,81,228,,
10,217156,212.0664063,220,164,384,,
10,231542,226.1152344,176,104,280,,
10,245924,240.1601563,269,75,344,,
10,260312,254.2109375,201,130,331,,
10,274688,268.25,768,666,1434,,
10,289058,282.2832031,144,83,227,,
10,303450,296.3378906,167,74,241,,
10,317832,310.3828125,715,645,1360,,
10,332216,324.4296875,969,820,1789,,
10,346594,338.4707031,670,602,1272,,
10,360980,352.5195313,421,349,770,,
10,375350,366.5527344,391,231,622,,
10,389746,380.6113281,684,585,1269,,
10,404124,394.6523438,811,712,1523,,
10,418500,408.6914063,532,443,975,,
10,432884,422.7382813,555,482,1037,,
10,447268,436.7851563,653,568,1221,,
10,461636,450.8164063,672,588,1260,,
10,476012,464.8554688,433,354,787,,
10,490406,478.9121094,708,600,1308,,
10,504796,492.9648438,596,495,1091,,
10,519168,507,636,506,1142,,
10,533536,521.03125,588,491,1079,,
10,547930,535.0878906,566,464,1030,,
10,562330,549.1503906,524,432,956,BAn15m3 (iteration 1),
10,15162,14.80664063,102,67,169,,
10,29530,28.83789063,131,90,221,,
10,43904,42.875,119,82,201,,
10,58258,56.89257813,147,108,255,,
10,72622,70.91992188,131,88,219,,
10,87712,85.65625,153,102,255,,
10,102086,99.69335938,142,105,247,,
10,116446,113.7167969,201,126,327,,
10,130800,127.734375,175,107,282,,
10,145188,141.7851563,623,565,1188,,
10,159564,155.8242188,173,89,262,,
10,173936,169.859375,144,84,228,,
10,188304,183.890625,430,367,797,,
10,202694,197.9433594,136,80,216,,
10,217064,211.9765625,144,88,232,,
10,231432,226.0078125,920,863,1783,,
10,245804,240.0429688,157,104,261,,
10,260192,254.09375,134,79,213,,
10,274574,268.1386719,142,81,223,,
10,288946,282.1738281,632,569,1201,,
10,303334,296.2246094,151,90,241,,
10,317712,310.265625,1040,975,2015,,
10,332094,324.3105469,527,447,974,,
10,346462,338.3417969,716,649,1365,,
10,360848,352.390625,556,486,1042,,
10,375226,366.4316406,528,443,971,,
10,389600,380.46875,590,512,1102,,
10,403982,394.5136719,951,875,1826,,
10,418362,408.5566406,418,329,747,,
10,432734,422.5917969,482,405,887,,
10,447120,436.640625,755,675,1430,,
10,461506,450.6894531,644,570,1214,,
10,475866,464.7128906,652,566,1218,,
10,490228,478.7382813,589,386,975,,
10,504600,492.7734375,567,484,1051,,
10,518982,506.8183594,535,453,988,,
10,533362,520.8613281,648,450,1098,,
10,547742,534.9042969,600,510,1110,,
10,562120,548.9453125,634,546,1180,BAn15m3 (iteration 2),
10,15174,14.81835938,124,69,193,,
10,29554,28.86132813,116,74,190,,
10,43936,42.90625,134,93,227,,
10,58332,56.96484375,112,81,193,,
10,72706,71.00195313,146,117,263,,
10,87782,85.72460938,127,82,209,,
10,102170,99.77539063,140,92,232,,
10,116536,113.8046875,134,90,224,,
10,130922,127.8535156,123,66,189,,
10,145308,141.9023438,125,76,201,,
10,159688,155.9453125,137,82,219,,
10,174066,169.9863281,164,100,264,,
10,188438,184.0214844,140,87,227,,
10,202810,198.0566406,319,267,586,,
10,217204,212.1132813,187,136,323,,
10,231578,226.1503906,139,84,223,,
10,245952,240.1875,163,105,268,,
10,260312,254.2109375,180,108,288,,
10,274702,268.2636719,1133,1060,2193,,
10,289072,282.296875,155,91,246,,
10,303464,296.3515625,147,86,233,,
10,317838,310.3886719,1967,1904,3871,,
10,332212,324.4257813,503,436,939,,
10,346580,338.4570313,620,544,1164,,
10,360960,352.5,846,766,1612,,
10,375316,366.5195313,579,484,1063,,
10,389692,380.5585938,675,588,1263,,
10,404070,394.5996094,289,189,478,,
10,418462,408.6542969,423,303,726,,
10,432850,422.7050781,729,615,1344,,
10,447240,436.7578125,941,833,1774,,
10,461626,450.8066406,780,643,1423,,
10,476010,464.8535156,836,722,1558,,
10,490384,478.890625,1070,1001,2071,,
10,504768,492.9375,293,206,499,,
10,519140,506.9726563,486,375,861,,
10,533538,521.0332031,612,529,1141,,
10,547904,535.0625,745,643,1388,,
10,562280,549.1015625,582,452,1034,BAn15m3 (iteration 3),
10,15160,14.8046875,110,71,181,,
10,29534,28.84179688,132,85,217,,
10,43910,42.88085938,123,81,204,,
10,58280,56.9140625,125,94,219,,
10,72654,70.95117188,128,96,224,,
10,87722,85.66601563,147,97,244,,
10,102102,99.70898438,203,142,345,,
10,116464,113.734375,224,143,367,,
10,130848,127.78125,150,91,241,,
10,145246,141.8417969,133,63,196,,
10,159628,155.8867188,140,77,217,,
10,174004,169.9257813,157,97,254,,
10,188380,183.9648438,255,196,451,,
10,202764,198.0117188,1035,967,2002,,
10,217140,212.0507813,165,109,274,,
10,231508,226.0820313,157,89,246,,
10,245882,240.1191406,159,94,253,,
10,260268,254.1679688,173,89,262,,
10,274638,268.2011719,157,96,253,,
10,289026,282.2519531,498,433,931,,
10,303394,296.2832031,179,114,293,,
10,317782,310.3339844,965,867,1832,,
10,332162,324.3769531,1184,1095,2279,,
10,346542,338.4199219,328,246,574,,
10,360922,352.4628906,793,645,1438,,
10,375300,366.5039063,647,537,1184,,
10,389684,380.5507813,575,470,1045,,
10,404070,394.5996094,801,729,1530,,
10,418450,408.6425781,375,298,673,,
10,432824,422.6796875,611,538,1149,,
10,447198,436.7167969,691,594,1285,,
10,461572,450.7539063,646,562,1208,,
10,475948,464.7929688,744,632,1376,,
10,490322,478.8300781,554,433,987,,
10,504692,492.8632813,738,636,1374,,
10,519060,506.8945313,651,569,1220,,
10,533420,520.9179688,1150,1053,2203,,
10,547796,534.9570313,327,219,546,,
10,562178,549.0019531,468,364,832,BAn15m3 (iteration 4),
10,15170,14.81445313,137,83,220,,
10,29556,28.86328125,133,79,212,,
10,43924,42.89453125,168,114,282,,
10,58298,56.93164063,160,117,277,,
10,72668,70.96484375,169,106,275,,
10,87738,85.68164063,139,94,233,,
10,102120,99.7265625,400,348,748,,
10,116508,113.7773438,134,86,220,,
10,130880,127.8125,150,102,252,,
10,145254,141.8496094,128,72,200,,
10,159626,155.8847656,127,69,196,,
10,173994,169.9160156,168,96,264,,
10,188372,183.9570313,173,94,267,,
10,202746,197.9941406,143,84,227,,
10,217128,212.0390625,156,82,238,,
10,231502,226.0761719,169,91,260,,
10,245874,240.1113281,1364,1282,2646,,
10,260260,254.1601563,177,95,272,,
10,274640,268.203125,171,90,261,,
10,289008,282.234375,170,90,260,,
10,303370,296.2597656,668,596,1264,,
10,317742,310.2949219,917,837,1754,,
10,332126,324.3417969,842,779,1621,,
10,346500,338.3789063,557,495,1052,,
10,360886,352.4277344,486,370,856,,
10,375250,366.4550781,213,115,328,,
10,389610,380.4785156,453,384,837,,
10,403992,394.5234375,377,306,683,,
10,418366,408.5605469,564,460,1024,,
10,432742,422.5996094,1393,1304,2697,,
10,447118,436.6386719,587,510,1097,,
10,461480,450.6640625,709,628,1337,,
10,475854,464.7011719,705,608,1313,,
10,490224,478.734375,486,401,887,,
10,504598,492.7714844,729,647,1376,,
10,518978,506.8144531,766,675,1441,,
10,533364,520.8632813,603,493,1096,,
10,547754,534.9160156,675,574,1249,,
10,562120,548.9453125,785,693,1478,BAn15m3 (iteration 5),
10,15166,14.81054688,105,69,174,,
10,29554,28.86132813,106,66,172,,
10,43934,42.90429688,116,74,190,,
10,58302,56.93554688,132,87,219,,
10,72690,70.98632813,146,97,243,,
10,87084,85.04296875,166,106,272,,
10,101480,99.1015625,161,102,263,,
10,115848,113.1328125,197,119,316,,
10,130208,127.15625,142,92,234,,
10,145276,141.8710938,151,100,251,,
10,160350,156.5917969,140,89,229,,
10,175432,171.3203125,148,90,238,,
10,190524,186.0585938,696,604,1300,,
10,205596,200.7773438,163,100,263,,
10,220674,215.5019531,426,353,779,,
10,235056,229.546875,145,83,228,,
10,249430,243.5839844,153,83,236,,
10,263812,257.6289063,600,524,1124,,
10,278184,271.6640625,189,98,287,,
10,292558,285.7011719,200,119,319,,
10,306926,299.7324219,193,92,285,,
10,321314,313.7832031,408,335,743,,
10,335690,327.8222656,784,704,1488,,
10,350056,341.8515625,560,483,1043,,
10,364418,355.8769531,722,653,1375,,
10,378794,369.9160156,1279,1165,2444,,
10,393160,383.9453125,390,296,686,,
10,407546,397.9941406,551,467,1018,,
10,421938,412.0488281,696,602,1298,,
10,436336,426.109375,483,405,888,,
10,450708,440.1445313,703,620,1323,,
10,465082,454.1816406,710,607,1317,,
10,479458,468.2207031,800,715,1515,,
10,493830,482.2558594,561,480,1041,,
10,508230,496.3183594,734,648,1382,,
10,522608,510.359375,640,556,1196,,
10,536976,524.390625,878,779,1657,,
10,551346,538.4238281,703,613,1316,,
10,565728,552.46875,549,449,998,,
10,580110,566.5136719,761,655,1416,,
10,594486,580.5527344,782,651,1433,,
10,608872,594.6015625,747,636,1383,,
10,623240,608.6328125,818,716,1534,,
10,637618,622.6738281,751,653,1404,,
10,652000,636.71875,1712,1599,3311,,
10,666368,650.75,1497,1382,2879,,
10,680740,664.7851563,1280,1167,2447,,
10,695128,678.8359375,1257,1156,2413,,
10,709512,692.8828125,1095,989,2084,,
10,723882,706.9160156,1545,1376,2921,,
10,738264,720.9609375,1051,915,1966,,
10,752638,734.9980469,1519,1331,2850,,
10,767004,749.0273438,1307,1168,2475,,
10,781394,763.0800781,1425,1310,2735,,
10,795762,777.1113281,1347,1231,2578,,
10,810142,791.1542969,976,800,1776,,
10,824520,805.1953125,1179,1064,2243,,
10,838908,819.2460938,1457,1279,2736,,
10,853288,833.2890625,1263,1075,2338,,
10,867670,847.3339844,1266,1150,2416,BAn15m5 (iteration 1),
10,15182,14.82617188,127,79,206,,
10,29574,28.88085938,132,78,210,,
10,43968,42.9375,172,95,267,,
10,58350,56.98242188,124,85,209,,
10,72722,71.01757813,124,82,206,,
10,87104,85.0625,154,102,256,,
10,101492,99.11328125,158,105,263,,
10,115862,113.1464844,129,95,224,,
10,130254,127.2011719,127,82,209,,
10,145326,141.9199219,147,97,244,,
10,160400,156.640625,2319,2268,4587,,
10,175458,171.3457031,161,100,261,,
10,190544,186.078125,147,73,220,,
10,205622,200.8027344,188,126,314,,
10,220694,215.5214844,458,388,846,,
10,235096,229.5859375,605,539,1144,,
10,249488,243.640625,132,74,206,,
10,263866,257.6816406,158,93,251,,
10,278234,271.7128906,147,89,236,,
10,292618,285.7597656,176,91,267,,
10,307002,299.8066406,184,98,282,,
10,321390,313.8574219,168,99,267,,
10,335770,327.9003906,1265,1200,2465,,
10,350142,341.9355469,529,465,994,,
10,364530,355.9863281,793,731,1524,,
10,378914,370.0332031,759,683,1442,,
10,393284,384.0664063,667,583,1250,,
10,407676,398.1210938,288,217,505,,
10,422050,412.1582031,732,654,1386,,
10,436444,426.2148438,786,710,1496,,
10,450822,440.2558594,665,568,1233,,
10,465202,454.2988281,356,282,638,,
10,479586,468.3457031,904,794,1698,,
10,493950,482.3730469,918,821,1739,,
10,508314,496.4003906,629,550,1179,,
10,522688,510.4375,764,677,1441,,
10,537062,524.4746094,1157,1064,2221,,
10,551450,538.5253906,401,287,688,,
10,565832,552.5703125,660,572,1232,,
10,580208,566.609375,706,605,1311,,
10,594568,580.6328125,893,743,1636,,
10,608956,594.6835938,782,697,1479,,
10,623334,608.7246094,854,757,1611,,
10,637718,622.7714844,703,598,1301,,
10,652098,636.8144531,1886,1749,3635,,
10,666482,650.8613281,1416,1269,2685,,
10,680858,664.9003906,1234,1139,2373,,
10,695228,678.9335938,1287,1188,2475,,
10,709624,692.9921875,968,858,1826,,
10,723992,707.0234375,1349,1235,2584,,
10,738368,721.0625,1468,1361,2829,,
10,752742,735.0996094,1076,970,2046,,
10,767122,749.1425781,1537,1395,2932,,
10,781504,763.1875,1090,972,2062,,
10,795892,777.2382813,1322,1203,2525,,
10,810276,791.2851563,1311,1181,2492,,
10,824654,805.3261719,1197,1058,2255,,
10,839046,819.3808594,1347,1227,2574,,
10,853422,833.4199219,990,874,1864,,
10,867814,847.4746094,1480,1366,2846,BAn15m5 (iteration 2),
10,15192,14.8359375,123,90,213,,
10,29568,28.875,144,83,227,,
10,43954,42.92382813,160,107,267,,
10,58328,56.9609375,108,73,181,,
10,72706,71.00195313,117,75,192,,
10,87084,85.04296875,136,80,216,,
10,101450,99.07226563,121,79,200,,
10,115822,113.1074219,134,89,223,,
10,130204,127.1523438,132,81,213,,
10,145288,141.8828125,147,98,245,,
10,160376,156.6171875,132,79,211,,
10,175452,171.3398438,407,348,755,,
10,190538,186.0722656,937,885,1822,,
10,205634,200.8144531,230,181,411,,
10,220712,215.5390625,560,510,1070,,
10,235086,229.5761719,205,129,334,,
10,249468,243.6210938,147,74,221,,
10,263838,257.6542969,155,97,252,,
10,278214,271.6933594,406,343,749,,
10,292586,285.7285156,146,87,233,,
10,306970,299.7753906,162,97,259,,
10,321352,313.8203125,1145,1082,2227,,
10,335734,327.8652344,763,670,1433,,
10,350104,341.8984375,751,677,1428,,
10,364480,355.9375,552,477,1029,,
10,378862,369.9824219,785,715,1500,,
10,393224,384.0078125,719,623,1342,,
10,407600,398.046875,796,720,1516,,
10,421960,412.0703125,746,676,1422,,
10,436348,426.1210938,479,400,879,,
10,450720,440.15625,1163,1102,2265,,
10,465100,454.1992188,693,608,1301,,
10,479476,468.2382813,870,752,1622,,
10,493852,482.2773438,840,724,1564,,
10,508216,496.3046875,548,431,979,,
10,522586,510.3378906,807,716,1523,,
10,536952,524.3671875,723,631,1354,,
10,551336,538.4140625,895,765,1660,,
10,565720,552.4609375,645,524,1169,,
10,580104,566.5078125,742,582,1324,,
10,594478,580.5449219,1439,1329,2768,,
10,608856,594.5859375,280,178,458,,
10,623228,608.6210938,701,590,1291,,
10,637618,622.6738281,934,823,1757,,
10,651994,636.7128906,1807,1715,3522,,
10,666374,650.7558594,1251,1151,2402,,
10,680754,664.7988281,1465,1344,2809,,
10,695130,678.8378906,1264,1157,2421,,
10,709512,692.8828125,1124,1020,2144,,
10,723886,706.9199219,1563,1459,3022,,
10,738264,720.9609375,1114,1007,2121,,
10,752640,735,1141,1034,2175,,
10,767010,749.0332031,1686,1493,3179,,
10,781380,763.0664063,1437,1242,2679,,
10,795756,777.1054688,1611,1488,3099,,
10,810140,791.1523438,1196,1088,2284,,
10,824504,805.1796875,1239,1055,2294,,
10,838864,819.203125,1231,1007,2238,,
10,853234,833.2363281,952,822,1774,,
10,867608,847.2734375,1242,1082,2324,BAn15m5 (iteration 3),
10,15174,14.81835938,124,74,198,,
10,29544,28.8515625,147,100,247,,
10,43930,42.90039063,142,77,219,,
10,58296,56.9296875,115,77,192,,
10,72692,70.98828125,126,83,209,,
10,87072,85.03125,129,98,227,,
10,101458,99.08007813,119,90,209,,
10,115838,113.1230469,127,100,227,,
10,130234,127.1816406,115,85,200,,
10,145298,141.8925781,138,91,229,,
10,160374,156.6152344,2601,2544,5145,,
10,175442,171.3300781,150,98,248,,
10,190524,186.0585938,136,82,218,,
10,205610,200.7910156,277,211,488,,
10,220682,215.5097656,459,401,860,,
10,235068,229.5585938,537,487,1024,,
10,249448,243.6015625,138,85,223,,
10,263824,257.640625,135,75,210,,
10,278200,271.6796875,144,87,231,,
10,292578,285.7207031,206,135,341,,
10,306954,299.7597656,158,98,256,,
10,321328,313.796875,187,95,282,,
10,335712,327.84375,1149,1090,2239,,
10,350086,341.8808594,546,480,1026,,
10,364470,355.9277344,842,773,1615,,
10,378838,369.9589844,418,338,756,,
10,393220,384.0039063,682,587,1269,,
10,407594,398.0410156,743,660,1403,,
10,421958,412.0683594,849,774,1623,,
10,436348,426.1210938,563,494,1057,,
10,450730,440.1660156,1175,1069,2244,,
10,465106,454.2050781,1093,1006,2099,,
10,479468,468.2304688,572,495,1067,,
10,493834,482.2597656,859,764,1623,,
10,508200,496.2890625,504,423,927,,
10,522574,510.3261719,843,754,1597,,
10,536930,524.3457031,801,714,1515,,
10,551316,538.3945313,811,721,1532,,
10,565678,552.4199219,563,460,1023,,
10,580056,566.4609375,911,811,1722,,
10,594450,580.5175781,693,589,1282,,
10,608832,594.5625,1489,1394,2883,,
10,623200,608.59375,430,345,775,,
10,637576,622.6328125,714,627,1341,,
10,651942,636.6621094,1740,1643,3383,,
10,666328,650.7109375,1423,1319,2742,,
10,680712,664.7578125,1249,1141,2390,,
10,695074,678.7832031,1220,1127,2347,,
10,709442,692.8144531,1226,1127,2353,,
10,723810,706.8457031,1419,1304,2723,,
10,738196,720.8945313,1168,1058,2226,,
10,752562,734.9238281,1618,1510,3128,,
10,766940,748.9648438,1431,1313,2744,,
10,781322,763.0097656,1531,1418,2949,,
10,795702,777.0527344,1244,1126,2370,,
10,810070,791.0839844,1415,1292,2707,,
10,824446,805.1230469,1216,1090,2306,,
10,838818,819.1582031,1178,1069,2247,,
10,853194,833.1972656,1193,1068,2261,,
10,867570,847.2363281,1046,931,1977,BAn15m5 (iteration 4),
10,15180,14.82421875,100,66,166,,
10,29558,28.86523438,137,78,215,,
10,43934,42.90429688,127,77,204,,
10,58312,56.9453125,107,70,177,,
10,72688,70.984375,130,88,218,,
10,87054,85.01367188,129,98,227,,
10,101432,99.0546875,131,95,226,,
10,115804,113.0898438,173,144,317,,
10,130172,127.1210938,118,75,193,,
10,145250,141.8457031,130,70,200,,
10,160330,156.5722656,2619,2569,5188,,
10,175408,171.296875,139,88,227,,
10,190490,186.0253906,139,86,225,,
10,205564,200.7460938,380,330,710,,
10,220644,215.4726563,629,565,1194,,
10,235032,229.5234375,150,84,234,,
10,249406,243.5605469,397,345,742,,
10,263776,257.59375,147,90,237,,
10,278168,271.6484375,138,79,217,,
10,292540,285.6835938,146,83,229,,
10,306908,299.7148438,164,84,248,,
10,321268,313.7382813,347,270,617,,
10,335650,327.7832031,815,737,1552,,
10,350038,341.8339844,631,551,1182,,
10,364408,355.8671875,755,689,1444,,
10,378792,369.9140625,656,578,1234,,
10,393164,383.9492188,1012,939,1951,,
10,407556,398.0039063,764,693,1457,,
10,421936,412.046875,533,460,993,,
10,436308,426.0820313,785,695,1480,,
10,450690,440.1269531,491,420,911,,
10,465076,454.1757813,1028,952,1980,,
10,479448,468.2109375,820,726,1546,,
10,493822,482.2480469,648,548,1196,,
10,508196,496.2851563,682,603,1285,,
10,522562,510.3144531,659,571,1230,,
10,536944,524.359375,1180,1076,2256,,
10,551318,538.3964844,833,750,1583,,
10,565702,552.4433594,585,494,1079,,
10,580064,566.46875,821,721,1542,,
10,594430,580.4980469,826,738,1564,,
10,608792,594.5234375,846,742,1588,,
10,623178,608.5722656,920,829,1749,,
10,637548,622.6054688,828,725,1553,,
10,651920,636.640625,1786,1673,3459,,
10,666282,650.6660156,1342,1243,2585,,
10,680662,664.7089844,1281,1176,2457,,
10,695022,678.7324219,1438,1334,2772,,
10,709416,692.7890625,1236,1137,2373,,
10,723778,706.8144531,1284,1179,2463,,
10,738140,720.8398438,1431,1308,2739,,
10,752506,734.8691406,1433,1333,2766,,
10,766882,748.9082031,1170,1069,2239,,
10,781262,762.9511719,1389,1278,2667,,
10,795630,776.9824219,1604,1500,3104,,
10,810006,791.0214844,1219,1105,2324,,
10,824378,805.0566406,1180,1068,2248,,
10,838744,819.0859375,1312,1193,2505,,
10,853126,833.1308594,1286,1152,2438,,
10,867506,847.1738281,1294,1066,2360,BAn15m5 (iteration 5),
10,15188,14.83203125,125,77,202,,
10,29552,28.859375,126,76,202,,
10,43920,42.890625,184,141,325,,
10,58300,56.93359375,119,78,197,,
10,72684,70.98046875,118,75,193,,
10,87052,85.01171875,121,75,196,,
10,101416,99.0390625,126,85,211,,
10,115796,113.0820313,140,110,250,,
10,130182,127.1308594,125,93,218,,
10,144554,141.1660156,128,83,211,,
10,158924,155.1992188,131,82,213,,
10,173304,169.2421875,144,86,230,,
10,187694,183.2949219,1602,1556,3158,,
10,202774,198.0214844,492,436,928,,
10,217862,212.7558594,726,677,1403,,
10,232938,227.4785156,136,85,221,,
10,248010,242.1972656,146,87,233,,
10,263076,256.9101563,171,115,286,,
10,278158,271.6386719,597,515,1112,,
10,293242,286.3691406,771,708,1479,,
10,308338,301.1113281,480,412,892,,
10,323424,315.84375,516,433,949,,
10,338490,330.5566406,553,484,1037,,
10,353570,345.2832031,937,839,1776,,
10,368644,360.0039063,784,716,1500,,
10,383718,374.7246094,939,853,1792,,
10,398800,389.453125,323,247,570,,
10,413874,404.1738281,1326,1263,2589,,
10,428248,418.2109375,243,171,414,,
10,442632,432.2578125,575,498,1073,,
10,457006,446.2949219,540,450,990,,
10,471370,460.3222656,695,601,1296,,
10,485742,474.3574219,485,411,896,,
10,500126,488.4042969,713,643,1356,,
10,514502,502.4433594,641,567,1208,,
10,528878,516.4824219,700,611,1311,,
10,543260,530.5273438,1230,1127,2357,,
10,557626,544.5566406,535,445,980,,
10,572002,558.5957031,667,576,1243,,
10,586374,572.6308594,582,502,1084,,
10,600738,586.6582031,820,739,1559,,
10,615112,600.6953125,591,508,1099,,
10,629472,614.71875,796,699,1495,,
10,643858,628.7675781,917,793,1710,,
10,658224,642.796875,2038,1937,3975,,
10,672592,656.828125,1335,1242,2577,,
10,686978,670.8769531,1560,1466,3026,,
10,701346,684.9082031,1397,1298,2695,,
10,715724,698.9492188,1345,1249,2594,,
10,730090,712.9785156,1366,1263,2629,,
10,744460,727.0117188,1466,1351,2817,,
10,758840,741.0546875,1195,1067,2262,,
10,773210,755.0878906,1365,1247,2612,,
10,787580,769.1210938,1379,1264,2643,,
10,801966,783.1699219,1419,1305,2724,,
10,816354,797.2207031,1504,1390,2894,,
10,830726,811.2558594,1639,1526,3165,,
10,845112,825.3046875,1171,1042,2213,,
10,859482,839.3378906,1735,1590,3325,,
10,873864,853.3828125,1375,1254,2629,,
10,888248,867.4296875,1215,1080,2295,,
10,902620,881.4648438,1537,1407,2944,,
10,917010,895.5175781,1506,1372,2878,,
10,931380,909.5507813,1812,1673,3485,,
10,945746,923.5800781,1711,1551,3262,,
10,960118,937.6152344,1864,1587,3451,,
10,974506,951.6660156,1700,1471,3171,,
10,988888,965.7109375,2340,2192,4532,,
10,1003262,979.7480469,2315,2166,4481,,
10,1017638,993.7871094,2354,2213,4567,,
10,1032030,1007.841797,2113,1876,3989,,
10,1046418,1021.892578,1950,1791,3741,,
10,1060800,1035.9375,1882,1734,3616,,
10,1075182,1049.982422,2132,1970,4102,,
10,1089552,1064.015625,2021,1870,3891,,
10,1103920,1078.046875,2003,1831,3834,,
10,1118286,1092.076172,1990,1838,3828,BAn15m7 (iteration 1),
10,15176,14.8203125,117,85,202,,
10,29568,28.875,138,89,227,,
10,43946,42.91601563,153,102,255,,
10,58312,56.9453125,124,85,209,,
10,72694,70.99023438,120,78,198,,
10,87072,85.03125,112,75,187,,
10,101456,99.078125,134,89,223,,
10,115836,113.1210938,126,96,222,,
10,130198,127.1464844,167,126,293,,
10,144576,141.1875,172,107,279,,
10,158948,155.2226563,168,113,281,,
10,173322,169.2597656,154,97,251,,
10,187692,183.2929688,2185,2136,4321,,
10,202762,198.0097656,1666,1610,3276,,
10,217836,212.7304688,467,414,881,,
10,232920,227.4609375,1011,951,1962,,
10,247984,242.171875,390,338,728,,
10,263064,256.8984375,867,806,1673,,
10,278130,271.6113281,521,466,987,,
10,293214,286.3417969,221,164,385,,
10,308298,301.0722656,1040,975,2015,,
10,323368,315.7890625,516,452,968,,
10,338446,330.5136719,554,492,1046,,
10,353524,345.2382813,790,724,1514,,
10,368598,359.9589844,646,578,1224,,
10,383664,374.671875,1078,1002,2080,,
10,398726,389.3808594,343,274,617,,
10,413812,404.1132813,1178,1080,2258,,
10,428184,418.1484375,455,393,848,,
10,442556,432.1835938,335,256,591,,
10,456930,446.2207031,662,592,1254,,
10,471314,460.2675781,779,684,1463,,
10,485692,474.3085938,818,735,1553,,
10,500052,488.3320313,599,522,1121,,
10,514420,502.3632813,668,587,1255,,
10,528790,516.3964844,859,775,1634,,
10,543170,530.4394531,843,746,1589,,
10,557542,544.4746094,909,807,1716,,
10,571924,558.5195313,589,459,1048,,
10,586302,572.5605469,984,821,1805,,
10,600678,586.5996094,624,543,1167,,
10,615050,600.6347656,895,805,1700,,
10,629424,614.671875,1260,1104,2364,,
10,643808,628.71875,1157,1005,2162,,
10,658190,642.7636719,1842,1696,3538,,
10,672570,656.8066406,1575,1461,3036,,
10,686942,670.8417969,1343,1234,2577,,
10,701308,684.8710938,1445,1336,2781,,
10,715678,698.9042969,1433,1317,2750,,
10,730052,712.9414063,1438,1315,2753,,
10,744422,726.9746094,1560,1440,3000,,
10,758794,741.0097656,1506,1387,2893,,
10,773174,755.0527344,1456,1333,2789,,
10,787552,769.09375,1237,1118,2355,,
10,801936,783.140625,1512,1400,2912,,
10,816304,797.171875,1609,1485,3094,,
10,830678,811.2089844,1333,1206,2539,,
10,845066,825.2597656,1605,1481,3086,,
10,859446,839.3027344,1424,1280,2704,,
10,873812,853.3320313,1377,1233,2610,,
10,888184,867.3671875,1399,1273,2672,,
10,902560,881.40625,1318,1196,2514,,
10,916936,895.4453125,1516,1384,2900,,
10,931310,909.4824219,1567,1412,2979,,
10,945692,923.5273438,1827,1678,3505,,
10,960068,937.5664063,1693,1506,3199,,
10,974428,951.5898438,1597,1449,3046,,
10,988790,965.6152344,2296,2143,4439,,
10,1003180,979.6679688,2136,1987,4123,,
10,1017560,993.7109375,2151,2002,4153,,
10,1031934,1007.748047,2043,1874,3917,,
10,1046318,1021.794922,1838,1691,3529,,
10,1060694,1035.833984,1912,1753,3665,,
10,1075076,1049.878906,2039,1774,3813,,
10,1089454,1063.919922,2074,1920,3994,,
10,1103822,1077.951172,1918,1754,3672,,
10,1118188,1091.980469,1929,1753,3682,BAn15m7 (iteration 2),
10,15162,14.80664063,146,101,247,,
10,29534,28.84179688,217,169,386,,
10,43922,42.89257813,162,97,259,,
10,58304,56.9375,119,75,194,,
10,72680,70.9765625,129,89,218,,
10,87054,85.01367188,121,67,188,,
10,101430,99.05273438,131,85,216,,
10,115798,113.0839844,137,78,215,,
10,130178,127.1269531,136,87,223,,
10,144562,141.1738281,131,81,212,,
10,158948,155.2226563,154,93,247,,
10,173320,169.2578125,162,93,255,,
10,188404,183.9882813,2023,1972,3995,,
10,203476,198.7070313,283,229,512,,
10,218560,213.4375,1110,1051,2161,,
10,233630,228.1542969,180,128,308,,
10,248710,242.8808594,198,124,322,,
10,263792,257.609375,1431,1353,2784,,
10,278870,272.3339844,176,95,271,,
10,293938,287.0488281,601,532,1133,,
10,309016,301.7734375,666,605,1271,,
10,324102,316.5058594,604,540,1144,,
10,339176,331.2265625,485,393,878,,
10,354246,345.9433594,492,392,884,,
10,369330,360.6738281,296,218,514,,
10,384410,375.4003906,809,742,1551,,
10,399486,390.1230469,1249,1156,2405,,
10,413854,404.1542969,403,333,736,,
10,428230,418.1933594,200,128,328,,
10,442606,432.2324219,699,622,1321,,
10,456978,446.2675781,450,358,808,,
10,471346,460.2988281,819,741,1560,,
10,485714,474.3300781,616,533,1149,,
10,500092,488.3710938,820,705,1525,,
10,514488,502.4296875,692,609,1301,,
10,528858,516.4628906,881,795,1676,,
10,543220,530.4882813,850,766,1616,,
10,557588,544.5195313,619,517,1136,,
10,571964,558.5585938,1077,983,2060,,
10,586332,572.5898438,841,748,1589,,
10,600700,586.6210938,907,805,1712,,
10,615084,600.6679688,641,538,1179,,
10,629446,614.6933594,924,826,1750,,
10,643836,628.7460938,1089,989,2078,,
10,658212,642.7851563,1809,1698,3507,,
10,672578,656.8144531,1586,1474,3060,,
10,686960,670.859375,1188,1067,2255,,
10,701336,684.8984375,1447,1300,2747,,
10,715718,698.9433594,1699,1581,3280,,
10,730088,712.9765625,1226,1110,2336,,
10,744462,727.0136719,1497,1383,2880,,
10,758850,741.0644531,1510,1396,2906,,
10,773232,755.109375,1741,1636,3377,,
10,787614,769.1542969,1260,1147,2407,,
10,801996,783.1992188,1596,1470,3066,,
10,816364,797.2304688,1615,1488,3103,,
10,830742,811.2714844,1353,1228,2581,,
10,845124,825.3164063,1225,1091,2316,,
10,859510,839.3652344,1662,1546,3208,,
10,873880,853.3984375,1098,984,2082,,
10,888270,867.4511719,1607,1490,3097,,
10,902638,881.4824219,1142,1014,2156,,
10,917016,895.5234375,2005,1848,3853,,
10,931402,909.5722656,1558,1418,2976,,
10,945788,923.6210938,1606,1460,3066,,
10,960168,937.6640625,1647,1493,3140,,
10,974538,951.6972656,1348,1192,2540,,
10,988910,965.7324219,2579,2403,4982,,
10,1003294,979.7792969,2533,2386,4919,,
10,1017678,993.8261719,1876,1701,3577,,
10,1032056,1007.867188,1946,1791,3737,,
10,1046428,1021.902344,2015,1804,3819,,
10,1060790,1035.927734,1939,1776,3715,,
10,1075162,1049.962891,2008,1809,3817,,
10,1089542,1064.005859,2021,1864,3885,,
10,1103904,1078.03125,2002,1849,3851,BAn15m7 (iteration 3),
10,15180,14.82421875,107,72,179,,
10,29548,28.85546875,110,66,176,,
10,43942,42.91210938,103,65,168,,
10,58314,56.94726563,106,71,177,,
10,72696,70.9921875,118,80,198,,
10,87064,85.0234375,138,86,224,,
10,101438,99.06054688,126,84,210,,
10,115810,113.0957031,145,92,237,,
10,130190,127.1386719,140,87,227,,
10,144562,141.1738281,137,86,223,,
10,158954,155.2285156,138,84,222,,
10,173322,169.2597656,146,91,237,,
10,187688,183.2890625,1336,1281,2617,,
10,202776,198.0234375,1954,1897,3851,,
10,217844,212.7382813,494,420,914,,
10,232922,227.4628906,160,102,262,,
10,248020,242.2070313,165,100,265,,
10,263102,256.9355469,310,242,552,,
10,278186,271.6660156,545,464,1009,,
10,293276,286.4023438,617,545,1162,,
10,308368,301.140625,564,472,1036,,
10,323442,315.8613281,522,436,958,,
10,338506,330.5722656,496,401,897,,
10,353586,345.2988281,624,515,1139,,
10,368664,360.0234375,682,610,1292,,
10,383732,374.7382813,945,817,1762,,
10,398798,389.4511719,619,520,1139,,
10,413868,404.1679688,1066,966,2032,,
10,428240,418.203125,440,364,804,,
10,442610,432.2363281,383,307,690,,
10,456980,446.2695313,725,640,1365,,
10,471348,460.3007813,711,638,1349,,
10,485724,474.3398438,571,477,1048,,
10,500106,488.3847656,754,660,1414,,
10,514474,502.4160156,767,685,1452,,
10,528866,516.4707031,603,519,1122,,
10,543236,530.5039063,871,765,1636,,
10,557614,544.5449219,909,821,1730,,
10,571992,558.5859375,575,469,1044,,
10,586366,572.6230469,985,890,1875,,
10,600762,586.6816406,620,512,1132,,
10,615146,600.7285156,964,864,1828,,
10,629528,614.7734375,1102,994,2096,,
10,643884,628.7929688,940,842,1782,,
10,658262,642.8339844,1954,1842,3796,,
10,672648,656.8828125,1633,1532,3165,,
10,687036,670.9335938,1493,1385,2878,,
10,701396,684.9570313,1265,1140,2405,,
10,715796,699.0195313,1500,1375,2875,,
10,730156,713.0429688,1512,1395,2907,,
10,744530,727.0800781,1467,1358,2825,,
10,758900,741.1132813,1510,1372,2882,,
10,773272,755.1484375,1470,1362,2832,,
10,787644,769.1835938,1523,1404,2927,,
10,802014,783.2167969,1370,1250,2620,,
10,816398,797.2636719,1564,1427,2991,,
10,830774,811.3027344,1706,1571,3277,,
10,845152,825.34375,1257,1119,2376,,
10,859540,839.3945313,2081,1930,4011,,
10,873920,853.4375,1634,1486,3120,,
10,888304,867.484375,1883,1745,3628,,
10,902686,881.5292969,1330,1207,2537,,
10,917062,895.5683594,1790,1662,3452,,
10,931434,909.6035156,1598,1463,3061,,
10,945810,923.6425781,1456,1307,2763,,
10,960198,937.6933594,1860,1702,3562,,
10,974572,951.7304688,1486,1343,2829,,
10,988940,965.7617188,2121,1961,4082,,
10,1003334,979.8183594,2540,2394,4934,,
10,1017722,993.8691406,2180,2040,4220,,
10,1032102,1007.912109,2126,1924,4050,,
10,1046474,1021.947266,1933,1695,3628,,
10,1060852,1035.988281,2001,1828,3829,,
10,1075236,1050.035156,1894,1748,3642,,
10,1089614,1064.076172,1920,1750,3670,,
10,1104004,1078.128906,1984,1798,3782,,
10,1118374,1092.162109,2087,1892,3979,BAn15m7 (iteration 4),
10,15174,14.81835938,104,71,175,,
10,29564,28.87109375,108,72,180,,
10,43940,42.91015625,117,83,200,,
10,58322,56.95507813,103,67,170,,
10,72698,70.99414063,137,93,230,,
10,87092,85.05078125,142,84,226,,
10,101478,99.09960938,131,83,214,,
10,115864,113.1484375,159,108,267,,
10,130236,127.1835938,135,85,220,,
10,144604,141.2148438,128,83,211,,
10,158978,155.2519531,179,133,312,,
10,173368,169.3046875,123,77,200,,
10,187760,183.359375,2301,2243,4544,,
10,202848,198.09375,735,684,1419,,
10,217936,212.828125,824,774,1598,,
10,233012,227.5507813,139,85,224,,
10,248074,242.2597656,148,89,237,,
10,263146,256.9785156,466,408,874,,
10,278216,271.6953125,164,90,254,,
10,293296,286.421875,612,537,1149,,
10,308376,301.1484375,582,500,1082,,
10,323458,315.8769531,578,500,1078,,
10,338536,330.6015625,564,473,1037,,
10,353618,345.3300781,684,604,1288,,
10,368690,360.0488281,697,614,1311,,
10,383766,374.7714844,986,886,1872,,
10,398846,389.4980469,414,323,737,,
10,413928,404.2265625,1270,1206,2476,,
10,428302,418.2636719,256,168,424,,
10,442680,432.3046875,744,649,1393,,
10,457064,446.3515625,711,637,1348,,
10,471428,460.3789063,813,733,1546,,
10,485806,474.4199219,521,436,957,,
10,500182,488.4589844,877,789,1666,,
10,514556,502.4960938,873,769,1642,,
10,528922,516.5253906,1178,1097,2275,,
10,543308,530.5742188,399,301,700,,
10,557678,544.6074219,785,700,1485,,
10,572062,558.6542969,881,788,1669,,
10,586446,572.7011719,849,746,1595,,
10,600820,586.7382813,628,513,1141,,
10,615202,600.7832031,986,881,1867,,
10,629582,614.8261719,772,651,1423,,
10,643956,628.8632813,1051,930,1981,,
10,658336,642.90625,1727,1632,3359,,
10,672708,656.9414063,1457,1359,2816,,
10,687076,670.9726563,1676,1571,3247,,
10,701454,685.0136719,1161,1056,2217,,
10,715838,699.0605469,1608,1482,3090,,
10,730218,713.1035156,1475,1319,2794,,
10,744594,727.1425781,1173,1043,2216,,
10,758950,741.1621094,1437,1324,2761,,
10,773320,755.1953125,1638,1528,3166,,
10,787690,769.2285156,1478,1349,2827,,
10,802076,783.2773438,1490,1379,2869,,
10,816468,797.3320313,1157,1044,2201,,
10,830838,811.3652344,1462,1336,2798,,
10,845214,825.4042969,1784,1644,3428,,
10,859592,839.4453125,1272,1148,2420,,
10,873968,853.484375,1855,1730,3585,,
10,888336,867.515625,1518,1398,2916,,
10,902730,881.5722656,1246,1123,2369,,
10,917096,895.6015625,1504,1379,2883,,
10,931478,909.6464844,1774,1637,3411,,
10,945850,923.6816406,1868,1685,3553,,
10,960222,937.7167969,1326,1180,2506,,
10,974610,951.7675781,1909,1761,3670,,
10,989004,965.8242188,2415,2261,4676,,
10,1003374,979.8574219,2340,2195,4535,,
10,1017746,993.8925781,2283,2149,4432,,
10,1032120,1007.929688,1915,1738,3653,,
10,1046496,1021.96875,1969,1824,3793,,
10,1060886,1036.021484,1890,1685,3575,,
10,1075254,1050.052734,1920,1757,3677,,
10,1089640,1064.101563,2014,1843,3857,,
10,1104002,1078.126953,1970,1793,3763,,
10,1118378,1092.166016,2098,1948,4046,BAn15m7 (iteration 5),
10,15178,14.82226563,148,92,240,,
10,29542,28.84960938,114,69,183,,
10,43906,42.87695313,124,77,201,,
10,58284,56.91796875,117,72,189,,
10,72670,70.96679688,133,71,204,,
10,87052,85.01171875,132,78,210,,
10,101436,99.05859375,108,66,174,,
10,115810,113.0957031,168,80,248,,
10,130194,127.1425781,158,107,265,,
10,144572,141.1835938,160,107,267,,
10,158958,155.2324219,116,72,188,,
10,173338,169.2753906,126,82,208,,
10,187734,183.3339844,130,80,210,,
10,202108,197.3710938,169,115,284,,
10,216472,211.3984375,264,196,460,,
10,230844,225.4335938,1656,1600,3256,,
10,245222,239.4746094,154,89,243,,
10,259604,253.5195313,143,88,231,,
10,273988,267.5664063,404,349,753,,
10,289074,282.2988281,3966,3907,7873,,
10,304152,297.0234375,635,575,1210,,
10,319232,311.75,527,461,988,,
10,334300,326.4648438,508,448,956,,
10,349376,341.1875,465,390,855,,
10,364468,355.9257813,513,454,967,,
10,379560,370.6640625,522,454,976,,
10,394644,385.3945313,451,385,836,,
10,409730,400.1269531,517,451,968,,
10,424810,414.8535156,628,546,1174,,
10,439890,429.5800781,759,681,1440,,
10,454960,444.296875,727,635,1362,,
10,470026,459.0097656,547,465,1012,,
10,485108,473.7382813,654,553,1207,,
10,500168,488.4453125,634,536,1170,,
10,515252,503.1757813,577,494,1071,,
10,530322,517.8925781,666,583,1249,,
10,545400,532.6171875,703,615,1318,,
10,560474,547.3378906,641,544,1185,,
10,575550,562.0605469,695,582,1277,,
10,590642,576.7988281,617,501,1118,,
10,605728,591.53125,1379,1260,2639,,
10,620796,606.2460938,889,792,1681,,
10,635862,620.9589844,1024,928,1952,,
10,650938,635.6816406,1027,916,1943,,
10,666004,650.3945313,1558,1445,3003,,
10,681084,665.1210938,1057,926,1983,,
10,696168,679.8515625,1408,1286,2694,,
10,711240,694.5703125,1490,1371,2861,,
10,726320,709.296875,1335,1215,2550,,
10,741380,724.0039063,1118,1011,2129,,
10,756454,738.7246094,1297,1174,2471,,
10,771520,753.4375,1429,1310,2739,,
10,786598,768.1621094,1607,1491,3098,,
10,801668,782.8789063,1458,1344,2802,,
10,816740,797.5976563,1418,1276,2694,,
10,831116,811.6367188,1537,1416,2953,,
10,845502,825.6855469,1283,1142,2425,,
10,859896,839.7421875,1468,1299,2767,,
10,874280,853.7890625,1453,1319,2772,,
10,888664,867.8359375,1534,1400,2934,,
10,903048,881.8828125,1412,1294,2706,,
10,917412,895.9101563,1466,1344,2810,,
10,931782,909.9433594,1598,1472,3070,,
10,946160,923.984375,1596,1455,3051,,
10,960522,938.0097656,1468,1342,2810,,
10,974904,952.0546875,1584,1439,3023,,
10,989270,966.0839844,2415,2279,4694,,
10,1003628,980.1054688,2564,2435,4999,,
10,1018004,994.1445313,2184,2043,4227,,
10,1032382,1008.185547,2208,2042,4250,,
10,1046756,1022.222656,2366,2226,4592,,
10,1061142,1036.271484,2186,2051,4237,,
10,1075514,1050.306641,2208,2064,4272,,
10,1089898,1064.353516,2277,2127,4404,,
10,1104270,1078.388672,2352,2192,4544,,
10,1118648,1092.429688,2241,2071,4312,,
10,1133020,1106.464844,2262,2107,4369,,
10,1147396,1120.503906,2316,2137,4453,,
10,1161764,1134.535156,2314,2119,4433,,
10,1176142,1148.576172,2302,2134,4436,,
10,1190526,1162.623047,2579,2414,4993,,
10,1204902,1176.662109,2391,2205,4596,,
10,1219282,1190.705078,2337,2168,4505,,
10,1233678,1204.763672,2356,2200,4556,,
10,1248058,1218.806641,2527,2335,4862,,
10,1262426,1232.837891,1981,1720,3701,,
10,1276802,1246.876953,2119,1913,4032,,
10,1291174,1260.912109,2236,1990,4226,,
10,1305536,1274.9375,2185,1972,4157,,
10,1319900,1288.964844,2785,2559,5344,,
10,1334270,1302.998047,2985,2766,5751,,
10,1348646,1317.037109,2916,2726,5642,,
10,1363028,1331.082031,3087,2897,5984,,
10,1377398,1345.115234,2920,2733,5653,,
10,1391770,1359.150391,2966,2709,5675,BAn15m10 (iteration 1),
10,15168,14.8125,115,85,200,,
10,29542,28.84960938,116,74,190,,
10,43922,42.89257813,140,88,228,,
10,58316,56.94921875,100,63,163,,
10,72690,70.98632813,139,86,225,,
10,87072,85.03125,172,91,263,,
10,101454,99.07617188,128,80,208,,
10,115830,113.1152344,117,72,189,,
10,130204,127.1523438,124,80,204,,
10,144576,141.1875,113,65,178,,
10,158960,155.234375,121,77,198,,
10,173322,169.2597656,113,65,178,,
10,187706,183.3066406,126,65,191,,
10,202072,197.3359375,165,112,277,,
10,216438,211.3652344,165,103,268,,
10,230814,225.4042969,2630,2581,5211,,
10,245194,239.4472656,139,88,227,,
10,259572,253.4882813,135,81,216,,
10,273944,267.5234375,129,73,202,,
10,289004,282.2304688,1936,1873,3809,,
10,304076,296.9492188,415,356,771,,
10,319164,311.6835938,1802,1734,3536,,
10,334232,326.3984375,626,560,1186,,
10,349308,341.1210938,1020,934,1954,,
10,364396,355.8554688,2846,2788,5634,,
10,379450,370.5566406,499,435,934,,
10,394522,385.2753906,506,433,939,,
10,409594,399.9941406,527,439,966,,
10,424676,414.7226563,558,485,1043,,
10,439746,429.4394531,571,489,1060,,
10,454832,444.171875,705,623,1328,,
10,469916,458.9023438,581,480,1061,,
10,484998,473.6308594,692,591,1283,,
10,500076,488.3554688,609,509,1118,,
10,515162,503.0878906,541,443,984,,
10,530258,517.8300781,562,473,1035,,
10,545344,532.5625,714,627,1341,,
10,560416,547.28125,522,432,954,,
10,575484,561.9960938,657,570,1227,,
10,590552,576.7109375,651,544,1195,,
10,605628,591.4335938,1375,1287,2662,,
10,620710,606.1621094,1203,1092,2295,,
10,635786,620.8847656,853,756,1609,,
10,650854,635.5996094,1001,897,1898,,
10,665938,650.3300781,1586,1443,3029,,
10,681008,665.046875,1027,910,1937,,
10,696080,679.765625,1513,1392,2905,,
10,711158,694.4902344,1148,1043,2191,,
10,726236,709.2148438,1408,1291,2699,,
10,741320,723.9453125,1502,1377,2879,,
10,756398,738.6699219,1177,1057,2234,,
10,771488,753.40625,1265,1143,2408,,
10,786574,768.1386719,1885,1769,3654,,
10,801646,782.8574219,1499,1376,2875,,
10,816730,797.5878906,1599,1459,3058,,
10,831114,811.6347656,1672,1546,3218,,
10,845482,825.6660156,1275,1151,2426,,
10,859850,839.6972656,1673,1558,3231,,
10,874228,853.7382813,1535,1421,2956,,
10,888602,867.7753906,1632,1490,3122,,
10,902978,881.8144531,1485,1366,2851,,
10,917362,895.8613281,1549,1420,2969,,
10,931752,909.9140625,1622,1500,3122,,
10,946122,923.9472656,1507,1371,2878,,
10,960494,937.9824219,1618,1481,3099,,
10,974884,952.0351563,1951,1790,3741,,
10,989246,966.0605469,2053,1913,3966,,
10,1003630,980.1074219,2614,2469,5083,,
10,1018010,994.1503906,2259,2108,4367,,
10,1032396,1008.199219,2227,2090,4317,,
10,1046780,1022.246094,2362,2216,4578,,
10,1061152,1036.28125,2128,1977,4105,,
10,1075542,1050.333984,2305,2148,4453,,
10,1089916,1064.371094,2312,2155,4467,,
10,1104296,1078.414063,2422,2265,4687,,
10,1118676,1092.457031,2326,2110,4436,,
10,1133036,1106.480469,2416,2248,4664,,
10,1147402,1120.509766,2506,2342,4848,,
10,1161768,1134.539063,2368,2208,4576,,
10,1176140,1148.574219,2392,2240,4632,,
10,1190512,1162.609375,2427,2265,4692,,
10,1204884,1176.644531,2309,2137,4446,,
10,1219252,1190.675781,2355,2180,4535,,
10,1233628,1204.714844,2479,2311,4790,,
10,1248002,1218.751953,2376,2206,4582,,
10,1262378,1232.791016,2111,1939,4050,,
10,1276756,1246.832031,2131,1922,4053,,
10,1291132,1260.871094,2139,1909,4048,,
10,1305500,1274.902344,2144,1934,4078,,
10,1319870,1288.935547,2743,2540,5283,,
10,1334252,1302.980469,3208,3008,6216,,
10,1348622,1317.013672,2818,2641,5459,,
10,1362984,1331.039063,2994,2800,5794,,
10,1377354,1345.072266,2874,2687,5561,,
10,1391722,1359.103516,2947,2751,5698,BAn15m10 (iteration 2),
10,15170,14.81445313,113,82,195,,
10,29544,28.8515625,134,90,224,,
10,43912,42.8828125,131,87,218,,
10,58276,56.91015625,100,64,164,,
10,72628,70.92578125,101,64,165,,
10,86998,84.95898438,133,91,224,,
10,101368,98.9921875,123,79,202,,
10,115736,113.0234375,167,103,270,,
10,130116,127.0664063,145,85,230,,
10,144500,141.1132813,109,68,177,,
10,158876,155.1523438,128,79,207,,
10,173264,169.203125,140,76,216,,
10,187648,183.25,114,67,181,,
10,202002,197.2675781,126,78,204,,
10,216378,211.3066406,172,122,294,,
10,230768,225.359375,706,639,1345,,
10,245142,239.3964844,1927,1874,3801,,
10,259524,253.4414063,182,112,294,,
10,273904,267.484375,181,119,300,,
10,288988,282.2148438,1446,1353,2799,,
10,304068,296.9414063,389,326,715,,
10,319138,311.6582031,990,928,1918,,
10,334214,326.3808594,615,552,1167,,
10,349288,341.1015625,395,330,725,,
10,364362,355.8222656,515,455,970,,
10,379428,370.5351563,2734,2648,5382,,
10,394506,385.2597656,667,597,1264,,
10,409572,399.9726563,613,534,1147,,
10,424670,414.7167969,584,503,1087,,
10,439740,429.4335938,653,576,1229,,
10,454826,444.1660156,564,470,1034,,
10,469910,458.8964844,700,616,1316,,
10,484988,473.6210938,593,509,1102,,
10,500056,488.3359375,631,524,1155,,
10,515130,503.0566406,629,520,1149,,
10,530200,517.7734375,660,518,1178,,
10,545292,532.5117188,695,578,1273,,
10,560382,547.2480469,546,426,972,,
10,575460,561.9726563,674,571,1245,,
10,590520,576.6796875,638,540,1178,,
10,605604,591.4101563,1471,1371,2842,,
10,620688,606.140625,1134,1033,2167,,
10,635754,620.8535156,1151,1053,2204,,
10,650818,635.5644531,998,899,1897,,
10,665896,650.2890625,998,887,1885,,
10,680970,665.0097656,1341,1238,2579,,
10,696050,679.7363281,1286,1180,2466,,
10,711138,694.4707031,1341,1229,2570,,
10,726212,709.1914063,1241,1116,2357,,
10,741290,723.9160156,1584,1464,3048,,
10,756368,738.640625,1312,1191,2503,,
10,771456,753.375,1387,1259,2646,,
10,786536,768.1015625,1798,1672,3470,,
10,801616,782.828125,1465,1355,2820,,
10,816688,797.546875,1587,1452,3039,,
10,831056,811.578125,1734,1613,3347,,
10,845442,825.6269531,1651,1508,3159,,
10,859830,839.6777344,1289,1174,2463,,
10,874218,853.7285156,1594,1471,3065,,
10,888602,867.7753906,1672,1549,3221,,
10,902990,881.8261719,1553,1436,2989,,
10,917362,895.8613281,1679,1553,3232,,
10,931740,909.9023438,1682,1554,3236,,
10,946120,923.9453125,1571,1415,2986,,
10,960502,937.9902344,1569,1437,3006,,
10,974880,952.03125,1746,1593,3339,,
10,989254,966.0683594,2714,2589,5303,,
10,1003646,980.1230469,2334,2193,4527,,
10,1018036,994.1757813,2312,2164,4476,,
10,1032416,1008.21875,2319,2189,4508,,
10,1046792,1022.257813,2344,2206,4550,,
10,1061176,1036.304688,2242,2104,4346,,
10,1075556,1050.347656,2376,2225,4601,,
10,1089944,1064.398438,2378,2237,4615,,
10,1104316,1078.433594,2443,2288,4731,,
10,1118694,1092.474609,2359,2184,4543,,
10,1133070,1106.513672,2529,2359,4888,,
10,1147456,1120.5625,2375,2211,4586,,
10,1161830,1134.599609,2474,2308,4782,,
10,1176206,1148.638672,2512,2320,4832,,
10,1190576,1162.671875,2381,2216,4597,,
10,1204952,1176.710938,2470,2299,4769,,
10,1219326,1190.748047,2493,2326,4819,,
10,1233698,1204.783203,2505,2335,4840,,
10,1248074,1218.822266,2478,2300,4778,,
10,1262448,1232.859375,2242,2030,4272,,
10,1276834,1246.908203,2014,1814,3828,,
10,1291206,1260.943359,2028,1820,3848,,
10,1305586,1274.986328,2167,1930,4097,,
10,1319964,1289.027344,2805,2597,5402,,
10,1334332,1303.058594,2830,2649,5479,,
10,1348722,1317.111328,2958,2773,5731,,
10,1363104,1331.15625,2842,2627,5469,,
10,1377472,1345.1875,2961,2765,5726,,
10,1391846,1359.224609,2884,2684,5568,BAn15m10 (iteration 3),
10,15160,14.8046875,126,86,212,,
10,29540,28.84765625,145,104,249,,
10,43928,42.8984375,105,66,171,,
10,58294,56.92773438,122,82,204,,
10,72678,70.97460938,123,85,208,,
10,87058,85.01757813,115,79,194,,
10,101428,99.05078125,127,73,200,,
10,115798,113.0839844,128,88,216,,
10,130168,127.1171875,128,69,197,,
10,144540,141.1523438,131,86,217,,
10,158916,155.1914063,134,80,214,,
10,173318,169.2558594,122,75,197,,
10,187692,183.2929688,163,111,274,,
10,202066,197.3300781,130,78,208,,
10,216438,211.3652344,190,127,317,,
10,230810,225.4003906,2541,2489,5030,,
10,245182,239.4355469,705,649,1354,,
10,259548,253.4648438,1255,1197,2452,,
10,273936,267.515625,143,86,229,,
10,289004,282.2304688,166,105,271,,
10,304096,296.96875,379,322,701,,
10,319192,311.7109375,1474,1411,2885,,
10,334272,326.4375,2797,2732,5529,,
10,349340,341.1523438,656,594,1250,,
10,364422,355.8808594,637,568,1205,,
10,379496,370.6015625,496,432,928,,
10,394574,385.3261719,544,470,1014,,
10,409646,400.0449219,613,512,1125,,
10,424724,414.7695313,719,619,1338,,
10,439794,429.4863281,682,590,1272,,
10,454870,444.2089844,525,448,973,,
10,469938,458.9238281,680,596,1276,,
10,485026,473.6582031,753,661,1414,,
10,500104,488.3828125,551,467,1018,,
10,515184,503.109375,650,569,1219,,
10,530270,517.8417969,847,719,1566,,
10,545346,532.5644531,658,576,1234,,
10,560428,547.2929688,449,366,815,,
10,575504,562.015625,632,546,1178,,
10,590584,576.7421875,596,508,1104,,
10,605656,591.4609375,1302,1215,2517,,
10,620744,606.1953125,1127,1004,2131,,
10,635812,620.9101563,913,717,1630,,
10,650890,635.6347656,1182,1030,2212,,
10,665978,650.3691406,1228,1060,2288,,
10,681044,665.0820313,1562,1444,3006,,
10,696120,679.8046875,1259,1156,2415,,
10,711204,694.5351563,1196,1078,2274,,
10,726280,709.2578125,1639,1525,3164,,
10,741352,723.9765625,1480,1353,2833,,
10,756432,738.703125,1383,1239,2622,,
10,771506,753.4238281,1067,947,2014,,
10,786602,768.1660156,1690,1570,3260,,
10,801668,782.8789063,1771,1642,3413,,
10,816748,797.6054688,1502,1359,2861,,
10,831140,811.6601563,1610,1473,3083,,
10,845522,825.7050781,1236,1124,2360,,
10,859892,839.7382813,1551,1437,2988,,
10,874282,853.7910156,1481,1351,2832,,
10,888662,867.8339844,1664,1535,3199,,
10,903046,881.8808594,1575,1452,3027,,
10,917412,895.9101563,1548,1418,2966,,
10,931768,909.9296875,1632,1499,3131,,
10,946142,923.9667969,1596,1464,3060,,
10,960522,938.0097656,1656,1509,3165,,
10,974892,952.0429688,1959,1799,3758,,
10,989264,966.078125,2510,2380,4890,,
10,1003646,980.1230469,2355,2218,4573,,
10,1018014,994.1542969,2327,2178,4505,,
10,1032382,1008.185547,2224,2077,4301,,
10,1046750,1022.216797,2355,2225,4580,,
10,1061138,1036.267578,2416,2256,4672,,
10,1075506,1050.298828,2295,2159,4454,,
10,1089880,1064.335938,2472,2314,4786,,
10,1104250,1078.369141,2378,2217,4595,,
10,1118620,1092.402344,2315,2107,4422,,
10,1132994,1106.439453,2371,2202,4573,,
10,1147364,1120.472656,2443,2274,4717,,
10,1161736,1134.507813,2362,2203,4565,,
10,1176100,1148.535156,2377,2223,4600,,
10,1190478,1162.576172,2363,2204,4567,,
10,1204846,1176.607422,2532,2369,4901,,
10,1219216,1190.640625,2414,2225,4639,,
10,1233588,1204.675781,2456,2279,4735,,
10,1247962,1218.712891,2643,2450,5093,,
10,1262338,1232.751953,2066,1847,3913,,
10,1276712,1246.789063,2127,1939,4066,,
10,1291068,1260.808594,2156,1951,4107,,
10,1305440,1274.84375,2146,1936,4082,,
10,1319820,1288.886719,2716,2495,5211,,
10,1334200,1302.929688,3052,2861,5913,,
10,1348584,1316.976563,2712,2526,5238,,
10,1362968,1331.023438,3018,2843,5861,,
10,1377336,1345.054688,3399,3213,6612,,
10,1391712,1359.09375,3617,3395,7012,BAn15m10 (iteration 4),
10,15162,14.80664063,164,99,263,,
10,29546,28.85351563,151,85,236,,
10,43902,42.87304688,175,122,297,,
10,58272,56.90625,123,74,197,,
10,72652,70.94921875,168,111,279,,
10,87030,84.99023438,133,79,212,,
10,101398,99.02148438,152,85,237,,
10,115788,113.0742188,165,99,264,,
10,130166,127.1152344,184,99,283,,
10,144530,141.1425781,175,92,267,,
10,158902,155.1777344,175,101,276,,
10,173278,169.2167969,147,88,235,,
10,187656,183.2578125,144,87,231,,
10,202036,197.3007813,129,79,208,,
10,216432,211.359375,139,69,208,,
10,230818,225.4082031,145,86,231,,
10,245190,239.4433594,154,101,255,,
10,259566,253.4824219,236,168,404,,
10,273960,267.5390625,2474,2382,4856,,
10,289034,282.2597656,3703,3627,7330,,
10,304116,296.9882813,908,847,1755,,
10,319202,311.7207031,537,472,1009,,
10,334280,326.4453125,464,403,867,,
10,349350,341.1621094,518,447,965,,
10,364428,355.8867188,3525,3454,6979,,
10,379512,370.6171875,729,659,1388,,
10,394594,385.3457031,802,731,1533,,
10,409666,400.0644531,555,478,1033,,
10,424738,414.7832031,596,514,1110,,
10,439818,429.5097656,640,555,1195,,
10,454898,444.2363281,834,662,1496,,
10,469966,458.9511719,698,507,1205,,
10,485054,473.6855469,727,631,1358,,
10,500126,488.4042969,660,570,1230,,
10,515206,503.1308594,681,591,1272,,
10,530276,517.8476563,788,707,1495,,
10,545364,532.5820313,729,632,1361,,
10,560448,547.3125,785,686,1471,,
10,575516,562.0273438,744,607,1351,,
10,590608,576.765625,734,626,1360,,
10,605674,591.4785156,1585,1460,3045,,
10,620740,606.1914063,1073,963,2036,,
10,635832,620.9296875,1032,928,1960,,
10,650902,635.6464844,977,866,1843,,
10,665992,650.3828125,1683,1573,3256,,
10,681064,665.1015625,1369,1257,2626,,
10,696122,679.8066406,1628,1506,3134,,
10,711202,694.5332031,1410,1237,2647,,
10,726292,709.2695313,1316,1186,2502,,
10,741388,724.0117188,1184,1060,2244,,
10,756464,738.734375,1549,1433,2982,,
10,771538,753.4550781,1444,1305,2749,,
10,786614,768.1777344,1995,1868,3863,,
10,801684,782.8945313,1937,1796,3733,,
10,816750,797.6074219,1460,1323,2783,,
10,831128,811.6484375,1624,1494,3118,,
10,845502,825.6855469,1342,1211,2553,,
10,859864,839.7109375,1643,1492,3135,,
10,874250,853.7597656,1568,1446,3014,,
10,888620,867.7929688,1520,1401,2921,,
10,903002,881.8378906,1631,1492,3123,,
10,917378,895.8769531,1563,1432,2995,,
10,931752,909.9140625,1656,1508,3164,,
10,946134,923.9589844,1696,1561,3257,,
10,960506,937.9941406,1599,1450,3049,,
10,974892,952.0429688,1675,1510,3185,,
10,989276,966.0898438,2473,2338,4811,,
10,1003644,980.1210938,2544,2400,4944,,
10,1018014,994.1542969,2372,2223,4595,,
10,1032388,1008.191406,2271,2128,4399,,
10,1046744,1022.210938,2449,2288,4737,,
10,1061130,1036.259766,2318,2165,4483,,
10,1075492,1050.285156,2337,2186,4523,,
10,1089868,1064.324219,2428,2242,4670,,
10,1104256,1078.375,2262,2088,4350,,
10,1118634,1092.416016,2045,1877,3922,,
10,1133022,1106.466797,2411,2257,4668,,
10,1147400,1120.507813,2484,2334,4818,,
10,1161782,1134.552734,2447,2288,4735,,
10,1176172,1148.605469,2591,2440,5031,,
10,1190544,1162.640625,2408,2248,4656,,
10,1204912,1176.671875,2521,2354,4875,,
10,1219264,1190.6875,2493,2315,4808,,
10,1233650,1204.736328,2468,2290,4758,,
10,1248024,1218.773438,2539,2330,4869,,
10,1262414,1232.826172,2122,1915,4037,,
10,1276788,1246.863281,2270,2046,4316,,
10,1291160,1260.898438,2072,1877,3949,,
10,1305542,1274.943359,2521,2317,4838,,
10,1319920,1288.984375,2741,2543,5284,,
10,1334298,1303.025391,3002,2810,5812,,
10,1348670,1317.060547,2916,2726,5642,,
10,1363038,1331.091797,3131,2950,6081,,
10,1377412,1345.128906,2898,2689,5587,,
10,1391790,1359.169922,3052,2835,5887,BAn15m10 (iteration 5),
